Season,Home_Team,Away_Team,Home_Score,Away_Score,Home_Goal_Diff,Away_Goal_Diff,Result,Home_Last_5_Wins,Away_Last_5_Wins,H2H_Home_Wins,H2H_Home_Losses,H2H_Away_Wins,H2H_Away_Losses,H2H_Draws,Home_Team_Avg_Goals_Scored,Home_Team_Avg_Goals_Conceded,Away_Team_Avg_Goals_Scored,Away_Team_Avg_Goals_Conceded,Result_Encoded,Home_Team_Recent_Form,Away_Team_Recent_Form,H2H_Home_Win_Ratio,H2H_Away_Win_Ratio,Goal_Difference
2012, Elman FC , Badbaado FC ,3,1,2,-2,Win,0,0,0,0,0,0,0,1.8493150684931507,1.3287671232876712,0.8260869565217391,2.4347826086956523,1.0,1.0,1.0,,,2
2012, Sahafi FC , Jeenyo  FC ,1,1,0,0,Draw,0,0,0,0,0,0,0,1.6774193548387097,1.4516129032258065,1.5846153846153845,1.4,0.0,0.0,0.0,,,0
2012, Heegan S.C , Dekedda SC ,1,1,0,0,Draw,0,0,0,0,0,0,0,1.5789473684210527,0.8947368421052632,1.662162162162162,0.8648648648648649,0.0,0.0,0.0,,,0
2012, Mogadishu City Club , Horseed S.C ,1,1,0,0,Draw,0,0,0,0,0,0,0,1.7671232876712328,0.9041095890410958,1.4583333333333333,1.1805555555555556,0.0,0.0,0.0,,,0
2012, Jeenyo  FC , Elman FC ,1,1,0,0,Draw,0,1,0,0,0,0,0,1.4366197183098592,1.5211267605633803,1.75,1.144736842105263,0.0,0.0,0.0,,,0
2012, Badbaado FC , Dekedda SC ,2,3,-1,1,Loss,0,0,0,0,0,0,0,0.6521739130434783,2.9565217391304346,1.662162162162162,0.8648648648648649,,,0.0,,,-1
2012, Sahafi FC , Horseed S.C ,1,1,0,0,Draw,0,0,0,0,0,0,0,1.6774193548387097,1.4516129032258065,1.4583333333333333,1.1805555555555556,0.0,0.0,0.0,,,0
2012, Heegan S.C , Mogadishu City Club ,3,2,1,-1,Win,0,0,0,0,0,0,0,1.5789473684210527,0.8947368421052632,1.96,0.7333333333333333,1.0,1.0,1.0,,,1
2012, Elman FC , Dekedda SC ,4,0,4,-4,Win,1,1,0,0,0,0,0,1.8493150684931507,1.3287671232876712,1.662162162162162,0.8648648648648649,1.0,2.0,1.0,,,4
2012, Jeenyo  FC , Horseed S.C ,0,0,0,0,Draw,0,0,0,0,0,0,0,1.4366197183098592,1.5211267605633803,1.4583333333333333,1.1805555555555556,0.0,0.0,0.0,,,0
2012, Badbaado FC , Mogadishu City Club ,0,3,-3,3,Loss,0,0,0,0,0,0,0,0.6521739130434783,2.9565217391304346,1.96,0.7333333333333333,,,1.0,,,-3
2012, Sahafi FC , Heegan S.C ,0,1,-1,1,Loss,0,1,0,0,0,0,0,1.6774193548387097,1.4516129032258065,1.917808219178082,0.8767123287671232,,0.0,,,,-1
2012, Horseed S.C , Elman FC ,1,3,-2,2,Loss,0,2,0,0,0,0,0,1.5714285714285714,0.935064935064935,1.75,1.144736842105263,,,0.0,,,-2
2012, Dekedda SC , Mogadishu City Club ,1,1,0,0,Draw,1,1,0,0,0,0,0,1.7333333333333334,1.04,1.96,0.7333333333333333,0.0,0.0,1.0,,,0
2012, Jeenyo  FC , Heegan S.C ,0,0,0,0,Draw,0,2,0,0,0,0,0,1.4366197183098592,1.5211267605633803,1.917808219178082,0.8767123287671232,0.0,0.0,0.0,,,0
2012, Badbaado FC , Sahafi FC ,0,1,-1,1,Loss,0,0,0,0,0,0,0,0.6521739130434783,2.9565217391304346,1.34375,1.34375,,,,,,-1
2012, Elman FC , Mogadishu City Club ,1,1,0,0,Draw,3,1,0,0,0,0,0,1.8493150684931507,1.3287671232876712,1.96,0.7333333333333333,0.0,2.0,1.0,,,0
2012, Horseed S.C , Heegan S.C ,2,2,0,0,Draw,0,2,0,0,0,0,0,1.5714285714285714,0.935064935064935,1.917808219178082,0.8767123287671232,0.0,0.0,0.0,,,0
2012, Dekedda SC , Sahafi FC ,0,0,0,0,Draw,1,1,0,0,0,0,0,1.7333333333333334,1.04,1.34375,1.34375,0.0,0.0,0.0,,,0
2012, Jeenyo  FC , Badbaado FC ,4,0,4,-4,Win,0,0,0,0,0,0,0,1.4366197183098592,1.5211267605633803,0.8260869565217391,2.4347826086956523,1.0,1.0,2.0,,,4
2012, Heegan S.C , Elman FC ,0,3,-3,3,Loss,2,3,0,0,0,0,0,1.5789473684210527,0.8947368421052632,1.75,1.144736842105263,,1.0,0.0,,,-3
2012, Mogadishu City Club , Sahafi FC ,1,0,1,-1,Win,1,1,0,0,0,0,0,1.7671232876712328,0.9041095890410958,1.34375,1.34375,1.0,1.0,1.0,,,1
2012, Horseed S.C , Badbaado FC ,2,0,2,-2,Win,0,0,0,0,0,0,0,1.5714285714285714,0.935064935064935,0.8260869565217391,2.4347826086956523,1.0,1.0,3.0,,,2
2012, Dekedda SC , Jeenyo  FC ,1,1,0,0,Draw,1,1,0,0,0,0,0,1.7333333333333334,1.04,1.5846153846153845,1.4,0.0,0.0,0.0,,,0
2012, Elman FC , Sahafi FC ,2,1,1,-1,Win,3,1,0,0,0,0,0,1.8493150684931507,1.3287671232876712,1.34375,1.34375,1.0,3.0,2.0,,,1
2012, Heegan S.C , Badbaado FC ,3,1,2,-2,Win,2,0,0,0,0,0,0,1.5789473684210527,0.8947368421052632,0.8260869565217391,2.4347826086956523,1.0,2.0,4.0,,,2
2012, Mogadishu City Club , Jeenyo  FC ,1,1,0,0,Draw,2,1,0,0,0,0,0,1.7671232876712328,0.9041095890410958,1.5846153846153845,1.4,0.0,1.0,0.0,,,0
2012, Horseed S.C , Dekedda SC ,2,1,1,-1,Win,1,1,0,0,0,0,0,1.5714285714285714,0.935064935064935,1.662162162162162,0.8648648648648649,1.0,2.0,2.0,,,1
2012, Badbaado FC , Elman FC ,2,5,-3,3,Loss,0,4,0,1,1,0,0,0.6521739130434783,2.9565217391304346,1.75,1.144736842105263,,,0.0,0.0,1.0,-3
2012, Jeenyo  FC , Sahafi FC ,1,1,0,0,Draw,1,1,0,0,0,0,1,1.4366197183098592,1.5211267605633803,1.34375,1.34375,0.0,1.0,2.0,0.0,0.0,0
2012, Dekedda SC , Heegan S.C ,2,4,-2,2,Loss,0,2,0,0,0,0,1,1.7333333333333334,1.04,1.917808219178082,0.8767123287671232,,0.0,0.0,0.0,0.0,-2
2012, Horseed S.C , Mogadishu City Club ,0,2,-2,2,Loss,2,2,0,0,0,0,1,1.5714285714285714,0.935064935064935,1.96,0.7333333333333333,,2.0,1.0,0.0,0.0,-2
2012, Elman FC , Jeenyo  FC ,1,2,-1,1,Loss,4,1,0,0,0,0,1,1.8493150684931507,1.3287671232876712,1.5846153846153845,1.4,,3.0,0.0,0.0,0.0,-1
2012, Dekedda SC , Badbaado FC ,5,1,4,-4,Win,0,0,0,0,0,0,0,1.7333333333333334,1.04,0.8260869565217391,2.4347826086956523,1.0,1.0,5.0,,,4
2012, Horseed S.C , Sahafi FC ,0,0,0,0,Draw,2,1,0,0,0,0,1,1.5714285714285714,0.935064935064935,1.34375,1.34375,0.0,2.0,2.0,0.0,0.0,0
2012, Mogadishu City Club , Heegan S.C ,1,1,0,0,Draw,2,2,0,1,1,0,0,1.7671232876712328,0.9041095890410958,1.917808219178082,0.8767123287671232,0.0,1.0,0.0,0.0,1.0,0
2012, Dekedda SC , Elman FC ,2,3,-1,1,Loss,1,3,0,1,1,0,0,1.7333333333333334,1.04,1.75,1.144736842105263,,1.0,0.0,0.0,1.0,-1
2012, Horseed S.C , Jeenyo  FC ,1,2,-1,1,Loss,2,2,0,0,0,0,1,1.5714285714285714,0.935064935064935,1.5846153846153845,1.4,,2.0,0.0,0.0,0.0,-1
2012, Mogadishu City Club , Badbaado FC ,2,2,0,0,Draw,2,0,0,0,0,0,0,1.7671232876712328,0.9041095890410958,0.8260869565217391,2.4347826086956523,0.0,1.0,4.0,,,0
2012, Heegan S.C , Sahafi FC ,2,0,2,-2,Win,2,0,0,0,0,0,0,1.5789473684210527,0.8947368421052632,1.34375,1.34375,1.0,3.0,3.0,,,2
2012, Elman FC , Horseed S.C ,2,0,2,-2,Win,4,2,0,0,0,0,0,1.8493150684931507,1.3287671232876712,1.4583333333333333,1.1805555555555556,1.0,3.0,1.0,,,2
2012, Mogadishu City Club , Dekedda SC ,1,2,-1,1,Loss,2,1,0,0,0,0,1,1.7671232876712328,0.9041095890410958,1.662162162162162,0.8648648648648649,,1.0,2.0,0.0,0.0,-1
2012, Heegan S.C , Jeenyo  FC ,0,1,-1,1,Loss,3,2,0,0,0,0,1,1.5789473684210527,0.8947368421052632,1.5846153846153845,1.4,,3.0,0.0,0.0,0.0,-1
2012, Sahafi FC , Badbaado FC ,2,1,1,-1,Win,0,0,0,0,0,0,0,1.6774193548387097,1.4516129032258065,0.8260869565217391,2.4347826086956523,1.0,1.0,4.0,,,1
2012, Mogadishu City Club , Elman FC ,1,2,-1,1,Loss,1,4,0,0,0,0,1,1.7671232876712328,0.9041095890410958,1.75,1.144736842105263,,0.0,,0.0,0.0,-1
2012, Heegan S.C , Horseed S.C ,1,0,1,-1,Win,3,1,0,0,0,0,1,1.5789473684210527,0.8947368421052632,1.4583333333333333,1.1805555555555556,1.0,3.0,2.0,0.0,0.0,1
2012, Sahafi FC , Dekedda SC ,0,0,0,0,Draw,1,2,0,0,0,0,1,1.6774193548387097,1.4516129032258065,1.662162162162162,0.8648648648648649,0.0,1.0,2.0,0.0,0.0,0
2012, Badbaado FC , Jeenyo  FC ,1,3,-2,2,Loss,0,3,0,1,1,0,0,0.6521739130434783,2.9565217391304346,1.5846153846153845,1.4,,,0.0,0.0,1.0,-2
2012, Elman FC , Heegan S.C ,1,3,-2,2,Loss,4,3,0,0,0,0,0,1.8493150684931507,1.3287671232876712,1.917808219178082,0.8767123287671232,,2.0,0.0,,,-2
2012, Sahafi FC , Mogadishu City Club ,0,0,0,0,Draw,1,1,0,1,1,0,0,1.6774193548387097,1.4516129032258065,1.96,0.7333333333333333,0.0,1.0,0.0,0.0,1.0,0
2012, Badbaado FC , Horseed S.C ,0,1,-1,1,Loss,0,0,0,1,1,0,0,0.6521739130434783,2.9565217391304346,1.4583333333333333,1.1805555555555556,,,2.0,0.0,1.0,-1
2012, Jeenyo  FC , Dekedda SC ,1,1,0,0,Draw,4,2,0,0,0,0,1,1.4366197183098592,1.5211267605633803,1.662162162162162,0.8648648648648649,0.0,1.0,2.0,0.0,0.0,0
2012, Sahafi FC , Elman FC ,0,2,-2,2,Loss,1,3,0,1,1,0,0,1.6774193548387097,1.4516129032258065,1.75,1.144736842105263,,1.0,,0.0,1.0,-2
2012, Badbaado FC , Heegan S.C ,0,3,-3,3,Loss,0,3,0,1,1,0,0,0.6521739130434783,2.9565217391304346,1.917808219178082,0.8767123287671232,,,0.0,0.0,1.0,-3
2012, Jeenyo  FC , Mogadishu City Club ,1,0,1,-1,Win,4,0,0,0,0,0,1,1.4366197183098592,1.5211267605633803,1.96,0.7333333333333333,1.0,2.0,1.0,0.0,0.0,1
2012, Dekedda SC , Horseed S.C ,2,2,0,0,Draw,2,1,0,1,1,0,0,1.7333333333333334,1.04,1.4583333333333333,1.1805555555555556,0.0,1.0,2.0,0.0,1.0,0
2013, Albeder , Ummah Hospital ,0,0,0,0,Draw,0,0,0,0,0,0,0,1.0,1.5714285714285714,1.0,1.2857142857142858,0.0,0.0,0.0,,,0
2013, Geeska Afrika FC , Midnimo FC ,2,1,1,-1,Win,0,0,0,0,0,0,0,1.0434782608695652,2.9130434782608696,1.4878048780487805,1.2682926829268293,1.0,1.0,1.0,,,1
2013, Sahafi FC , Badbaado FC ,1,0,1,-1,Win,1,0,1,0,0,1,0,1.6774193548387097,1.4516129032258065,0.8260869565217391,2.4347826086956523,1.0,2.0,4.0,1.0,0.0,1
2013, Bariga Dhexe , Jazeera SC ,2,1,1,-1,Win,0,0,0,0,0,0,0,2.0,2.176470588235294,1.605263157894737,2.0789473684210527,1.0,1.0,1.0,,,1
2013, SomaliFruit FC , Gantaalaha Afgooye FC ,2,0,2,-2,Win,0,0,0,0,0,0,0,1.25,1.8125,1.2857142857142858,1.8571428571428572,1.0,1.0,1.0,,,2
2013, Waxool FC , ,6,0,6,-6,Win,0,0,0,0,0,0,0,1.1142857142857143,2.142857142857143,0.7272727272727273,2.9545454545454546,1.0,1.0,1.0,,,6
2013, Madbacadda FC , ,0,0,0,0,Draw,0,0,0,0,0,0,0,0.8,1.72,0.7272727272727273,2.9545454545454546,0.0,0.0,1.0,,,0
2013, Raadsan FC , Gasko FC ,4,2,2,-2,Win,0,0,0,0,0,0,0,1.7407407407407407,1.4074074074074074,0.8571428571428571,2.357142857142857,1.0,1.0,1.0,,,2
2013, Badbaado FC , Albeder ,1,1,0,0,Draw,0,0,0,0,0,0,0,0.6521739130434783,2.9565217391304346,1.4285714285714286,1.5714285714285714,0.0,0.0,0.0,,,0
2013, Jamhuuriya FC , Jazeera SC ,2,3,-1,1,Loss,0,0,0,0,0,0,0,2.2666666666666666,1.2,1.605263157894737,2.0789473684210527,,,1.0,,,-1
2013, Ummah Hospital , Gantaalaha Afgooye FC ,2,1,1,-1,Win,0,0,0,0,0,0,0,2.142857142857143,1.4285714285714286,1.2857142857142858,1.8571428571428572,1.0,1.0,2.0,,,1
2013, Geeska Afrika FC , ,2,1,1,-1,Win,1,0,0,0,0,0,0,1.0434782608695652,2.9130434782608696,0.7272727272727273,2.9545454545454546,1.0,2.0,2.0,,,1
2013, Sahafi FC , ,2,2,0,0,Draw,2,0,0,0,0,0,0,1.6774193548387097,1.4516129032258065,0.7272727272727273,2.9545454545454546,0.0,1.0,2.0,,,0
2013, Bariga Dhexe , Gasko FC ,6,0,6,-6,Win,1,0,0,0,0,0,0,2.0,2.176470588235294,0.8571428571428571,2.357142857142857,1.0,2.0,2.0,,,6
2013, SomaliFruit FC , Madbacadda FC ,2,3,-1,1,Loss,1,0,0,0,0,0,0,1.25,1.8125,0.9166666666666666,1.5833333333333333,,1.0,,,,-1
2013, Waxool FC , Raadsan FC ,1,1,0,0,Draw,1,1,0,0,0,0,0,1.1142857142857143,2.142857142857143,1.59375,1.46875,0.0,1.0,0.0,,,0
2013, Albeder , Gantaalaha Afgooye FC ,3,2,1,-1,Win,0,0,0,0,0,0,0,1.0,1.5714285714285714,1.2857142857142858,1.8571428571428572,1.0,1.0,3.0,,,1
2013, Midnimo FC , ,2,0,2,-2,Win,0,0,0,0,0,0,0,1.4857142857142858,1.3714285714285714,0.7272727272727273,2.9545454545454546,1.0,1.0,3.0,,,2
2013, Badbaado FC , ,0,1,-1,1,Loss,0,0,0,0,0,0,0,0.6521739130434783,2.9565217391304346,0.7272727272727273,2.9545454545454546,,0.0,2.0,,,-1
2013, Jamhuuriya FC , Gasko FC ,1,0,1,-1,Win,0,0,0,0,0,0,0,2.2666666666666666,1.2,0.8571428571428571,2.357142857142857,1.0,1.0,3.0,,,1
2013, Ummah Hospital , Madbacadda FC ,2,0,2,-2,Win,1,1,0,0,0,0,0,2.142857142857143,1.4285714285714286,0.9166666666666666,1.5833333333333333,1.0,2.0,1.0,,,2
2013, Geeska Afrika FC , Raadsan FC ,1,2,-1,1,Loss,2,1,0,0,0,0,0,1.0434782608695652,2.9130434782608696,1.59375,1.46875,,2.0,0.0,,,-1
2013, Sahafi FC , SomaliFruit FC ,3,1,2,-2,Win,1,1,0,0,0,0,0,1.6774193548387097,1.4516129032258065,1.3333333333333333,1.6666666666666667,1.0,2.0,1.0,,,2
2013, Bariga Dhexe , Waxool FC ,1,1,0,0,Draw,2,1,0,0,0,0,0,2.0,2.176470588235294,1.4285714285714286,1.8571428571428572,0.0,2.0,0.0,,,0
2013, , Albeder ,2,2,0,0,Draw,1,1,0,0,0,0,0,1.05,2.75,1.4285714285714286,1.5714285714285714,0.0,0.0,0.0,,,0
2013, Jazeera SC , Gasko FC ,1,0,1,-1,Win,1,0,0,0,0,0,0,1.205128205128205,2.230769230769231,0.8571428571428571,2.357142857142857,1.0,1.0,4.0,,,1
2013, Gantaalaha Afgooye FC , Madbacadda FC ,1,0,1,-1,Win,0,1,0,0,0,0,0,0.7142857142857143,1.0,0.9166666666666666,1.5833333333333333,1.0,1.0,2.0,,,1
2013, Midnimo FC , Raadsan FC ,1,2,-1,1,Loss,1,2,0,0,0,0,0,1.4857142857142858,1.3714285714285714,1.59375,1.46875,,1.0,0.0,,,-1
2013, Badbaado FC , SomaliFruit FC ,0,5,-5,5,Loss,0,1,0,0,0,0,0,0.6521739130434783,2.9565217391304346,1.3333333333333333,1.6666666666666667,,0.0,1.0,,,-5
2013, Jamhuuriya FC , Waxool FC ,1,1,0,0,Draw,1,1,0,0,0,0,0,2.2666666666666666,1.2,1.4285714285714286,1.8571428571428572,0.0,1.0,0.0,,,0
2013, Ummah Hospital , Sahafi FC ,3,1,2,-2,Win,2,2,0,0,0,0,0,2.142857142857143,1.4285714285714286,1.34375,1.34375,1.0,3.0,3.0,,,2
2013, Geeska Afrika FC , Bariga Dhexe ,0,2,-2,2,Loss,2,2,0,0,0,0,0,1.0434782608695652,2.9130434782608696,1.1764705882352942,1.411764705882353,,2.0,,,,-2
2013, Albeder , Madbacadda FC ,0,1,-1,1,Loss,1,1,0,0,0,0,0,1.0,1.5714285714285714,0.9166666666666666,1.5833333333333333,,1.0,2.0,,,-1
2013, , Raadsan FC ,0,1,-1,1,Loss,1,3,0,0,0,0,0,1.05,2.75,1.59375,1.46875,,0.0,0.0,,,-1
2013, , SomaliFruit FC ,0,0,0,0,Draw,1,2,0,0,0,0,0,1.05,2.75,1.3333333333333333,1.6666666666666667,0.0,0.0,1.0,,,0
2013, Jazeera SC , Waxool FC ,1,3,-2,2,Loss,2,1,0,0,0,0,0,1.205128205128205,2.230769230769231,1.4285714285714286,1.8571428571428572,,1.0,0.0,,,-2
2013, Gantaalaha Afgooye FC , Sahafi FC ,0,3,-3,3,Loss,1,2,0,0,0,0,0,0.7142857142857143,1.0,1.34375,1.34375,,1.0,2.0,,,-3
2013, Midnimo FC , Bariga Dhexe ,1,0,1,-1,Win,1,3,0,0,0,0,0,1.4857142857142858,1.3714285714285714,1.1764705882352942,1.411764705882353,1.0,2.0,1.0,,,1
2013, Badbaado FC , Ummah Hospital ,1,1,0,0,Draw,0,3,0,0,0,0,0,0.6521739130434783,2.9565217391304346,1.0,1.2857142857142858,0.0,0.0,0.0,,,0
2013, Jamhuuriya FC , Geeska Afrika FC ,1,1,0,0,Draw,1,2,0,0,0,0,0,2.2666666666666666,1.2,1.2173913043478262,2.5217391304347827,0.0,1.0,0.0,,,0
2013, SomaliFruit FC , Albeder ,1,1,0,0,Draw,2,1,0,0,0,0,0,1.25,1.8125,1.4285714285714286,1.5714285714285714,0.0,1.0,0.0,,,0
2013, Gasko FC , Waxool FC ,2,5,-3,3,Loss,0,2,0,0,0,0,0,1.4285714285714286,1.7142857142857142,1.4285714285714286,1.8571428571428572,,,0.0,,,-3
2013, Madbacadda FC , Sahafi FC ,1,1,0,0,Draw,2,3,0,0,0,0,0,0.8,1.72,1.34375,1.34375,0.0,0.0,2.0,,,0
2013, , Bariga Dhexe ,0,4,-4,4,Loss,1,3,0,0,0,0,0,1.05,2.75,1.1764705882352942,1.411764705882353,,0.0,1.0,,,-4
2013, , Ummah Hospital ,2,2,0,0,Draw,1,3,0,0,0,0,0,1.05,2.75,1.0,1.2857142857142858,0.0,0.0,0.0,,,0
2013, Jazeera SC , Geeska Afrika FC ,1,1,0,0,Draw,2,2,0,0,0,0,0,1.205128205128205,2.230769230769231,1.2173913043478262,2.5217391304347827,0.0,1.0,0.0,,,0
2013, Gantaalaha Afgooye FC , Badbaado FC ,0,2,-2,2,Loss,1,0,0,0,0,0,0,0.7142857142857143,1.0,0.8260869565217391,2.4347826086956523,,1.0,3.0,,,-2
2013, Midnimo FC , Jamhuuriya FC ,1,1,0,0,Draw,2,1,0,0,0,0,0,1.4857142857142858,1.3714285714285714,1.6153846153846154,2.0,0.0,2.0,0.0,,,0
2013, Albeder , Sahafi FC ,0,3,-3,3,Loss,1,2,0,0,0,0,0,1.0,1.5714285714285714,1.34375,1.34375,,1.0,2.0,,,-3
2013, Raadsan FC , Bariga Dhexe ,1,2,-1,1,Loss,4,3,0,0,0,0,0,1.7407407407407407,1.4074074074074074,1.1764705882352942,1.411764705882353,,1.0,1.0,,,-1
2013, SomaliFruit FC , Ummah Hospital ,1,1,0,0,Draw,1,3,0,0,0,0,0,1.25,1.8125,1.0,1.2857142857142858,0.0,1.0,0.0,,,0
2013, Gasko FC , Geeska Afrika FC ,4,2,2,-2,Win,0,1,0,0,0,0,0,1.4285714285714286,1.7142857142857142,1.2173913043478262,2.5217391304347827,1.0,1.0,1.0,,,2
2013, Madbacadda FC , Badbaado FC ,1,2,-1,1,Loss,2,1,0,0,0,0,0,0.8,1.72,0.8260869565217391,2.4347826086956523,,0.0,2.0,,,-1
2013, , Jamhuuriya FC ,1,2,-1,1,Loss,0,1,0,0,0,0,0,1.05,2.75,1.6153846153846154,2.0,,0.0,0.0,,,-1
2013, , Gantaalaha Afgooye FC ,1,1,0,0,Draw,0,1,0,0,0,0,0,1.05,2.75,1.2857142857142858,1.8571428571428572,0.0,0.0,3.0,,,0
2013, Waxool FC , Geeska Afrika FC ,1,1,0,0,Draw,2,0,0,0,0,0,0,1.1142857142857143,2.142857142857143,1.2173913043478262,2.5217391304347827,0.0,1.0,1.0,,,0
2013, Raadsan FC , Jamhuuriya FC ,0,2,-2,2,Loss,3,2,0,0,0,0,0,1.7407407407407407,1.4074074074074074,1.6153846153846154,2.0,,1.0,0.0,,,-2
2013, Gasko FC , Midnimo FC ,0,0,0,0,Draw,1,2,0,0,0,0,0,1.4285714285714286,1.7142857142857142,1.4878048780487805,1.2682926829268293,0.0,1.0,1.0,,,0
2013, , Jazeera SC ,0,3,-3,3,Loss,0,2,0,0,0,0,0,1.05,2.75,1.605263157894737,2.0789473684210527,,0.0,1.0,,,-3
2013, Bariga Dhexe , Jamhuuriya FC ,0,1,-1,1,Loss,3,2,0,0,0,0,0,2.0,2.176470588235294,1.6153846153846154,2.0,,2.0,0.0,,,-1
2013, Waxool FC , Midnimo FC ,3,0,3,-3,Win,2,2,0,0,0,0,0,1.1142857142857143,2.142857142857143,1.4878048780487805,1.2682926829268293,1.0,2.0,2.0,,,3
2013, Raadsan FC , Jazeera SC ,3,2,1,-1,Win,3,3,0,0,0,0,0,1.7407407407407407,1.4074074074074074,1.605263157894737,2.0789473684210527,1.0,2.0,2.0,,,1
2013, Gasko FC , ,4,1,3,-3,Win,1,0,0,0,0,0,0,1.4285714285714286,1.7142857142857142,0.7272727272727273,2.9545454545454546,1.0,2.0,3.0,,,3
2013, Jazeera SC , Midnimo FC ,2,1,1,-1,Win,2,1,0,0,0,0,0,1.205128205128205,2.230769230769231,1.4878048780487805,1.2682926829268293,1.0,2.0,3.0,,,1
2013, Midnimo FC , Geeska Afrika FC ,2,1,1,-1,Win,1,0,0,1,1,0,0,1.4857142857142858,1.3714285714285714,1.2173913043478262,2.5217391304347827,1.0,3.0,2.0,0.0,1.0,1
2013, Ummah Hospital , Albeder ,2,2,0,0,Draw,2,1,0,0,0,0,1,2.142857142857143,1.4285714285714286,1.4285714285714286,1.5714285714285714,0.0,3.0,0.0,0.0,0.0,0
2013, Jazeera SC , Bariga Dhexe ,0,3,-3,3,Loss,2,3,0,1,1,0,0,1.205128205128205,2.230769230769231,1.1764705882352942,1.411764705882353,,2.0,1.0,0.0,1.0,-3
2013, Badbaado FC , Sahafi FC ,0,2,-2,2,Loss,2,3,0,2,2,0,0,0.6521739130434783,2.9565217391304346,1.34375,1.34375,,0.0,1.0,0.0,1.0,-2
2013, , Waxool FC ,1,4,-3,3,Loss,0,3,0,1,1,0,0,1.05,2.75,1.4285714285714286,1.8571428571428572,,0.0,0.0,0.0,1.0,-3
2013, Gantaalaha Afgooye FC , SomaliFruit FC ,1,0,1,-1,Win,1,1,0,1,1,0,0,0.7142857142857143,1.0,1.3333333333333333,1.6666666666666667,1.0,2.0,2.0,0.0,1.0,1
2013, Gasko FC , Raadsan FC ,2,1,1,-1,Win,2,3,0,1,1,0,0,1.4285714285714286,1.7142857142857142,1.59375,1.46875,1.0,3.0,1.0,0.0,1.0,1
2013, , Madbacadda FC ,2,1,1,-1,Win,0,1,0,0,0,0,1,1.05,2.75,0.9166666666666666,1.5833333333333333,1.0,1.0,3.0,0.0,0.0,1
2013, Jazeera SC , Jamhuuriya FC ,3,2,1,-1,Win,2,3,0,0,0,0,0,1.205128205128205,2.230769230769231,1.6153846153846154,2.0,1.0,2.0,1.0,,,1
2013, Albeder , Badbaado FC ,1,1,0,0,Draw,0,2,0,0,0,0,1,1.0,1.5714285714285714,0.8260869565217391,2.4347826086956523,0.0,1.0,2.0,0.0,0.0,0
2013, , Geeska Afrika FC ,2,2,0,0,Draw,1,0,0,1,1,0,0,1.05,2.75,1.2173913043478262,2.5217391304347827,0.0,1.0,2.0,0.0,1.0,0
2013, Gantaalaha Afgooye FC , Ummah Hospital ,1,1,0,0,Draw,2,1,0,1,1,0,0,0.7142857142857143,1.0,1.0,1.2857142857142858,0.0,2.0,0.0,0.0,1.0,0
2013, Gasko FC , Bariga Dhexe ,0,0,0,0,Draw,3,3,0,1,1,0,0,1.4285714285714286,1.7142857142857142,1.1764705882352942,1.411764705882353,0.0,3.0,1.0,0.0,1.0,0
2013, , Sahafi FC ,1,3,-2,2,Loss,1,3,0,0,0,0,1,1.05,2.75,1.34375,1.34375,,1.0,0.0,0.0,0.0,-2
2013, Raadsan FC , Waxool FC ,2,1,1,-1,Win,2,4,0,0,0,0,1,1.7407407407407407,1.4074074074074074,1.4285714285714286,1.8571428571428572,1.0,3.0,1.0,0.0,0.0,1
2013, Madbacadda FC , SomaliFruit FC ,0,3,-3,3,Loss,1,1,0,0,0,0,0,0.8,1.72,1.3333333333333333,1.6666666666666667,,0.0,2.0,,,-3
2013, , Midnimo FC ,0,1,-1,1,Loss,1,1,0,1,1,0,0,1.05,2.75,1.4878048780487805,1.2682926829268293,,1.0,3.0,0.0,1.0,-1
2013, Gantaalaha Afgooye FC , Albeder ,1,1,0,0,Draw,1,0,0,1,1,0,0,0.7142857142857143,1.0,1.4285714285714286,1.5714285714285714,0.0,1.0,0.0,0.0,1.0,0
2013, Gasko FC , Jamhuuriya FC ,1,2,-1,1,Loss,3,3,0,1,1,0,0,1.4285714285714286,1.7142857142857142,1.6153846153846154,2.0,,2.0,1.0,0.0,1.0,-1
2013, , Badbaado FC ,0,1,-1,1,Loss,1,2,0,0,0,0,0,1.05,2.75,0.8260869565217391,2.4347826086956523,,1.0,1.0,,,-1
2013, Raadsan FC , Geeska Afrika FC ,1,1,0,0,Draw,2,0,0,0,0,0,0,1.7407407407407407,1.4074074074074074,1.2173913043478262,2.5217391304347827,0.0,2.0,2.0,,,0
2013, Madbacadda FC , Ummah Hospital ,0,0,0,0,Draw,1,0,0,1,1,0,0,0.8,1.72,1.0,1.2857142857142858,0.0,0.0,0.0,0.0,1.0,0
2013, Waxool FC , Bariga Dhexe ,3,1,2,-2,Win,3,3,0,0,0,0,1,1.1142857142857143,2.142857142857143,1.1764705882352942,1.411764705882353,1.0,3.0,1.0,0.0,0.0,2
2013, SomaliFruit FC , Sahafi FC ,1,3,-2,2,Loss,1,4,0,1,1,0,0,1.25,1.8125,1.34375,1.34375,,1.0,0.0,0.0,1.0,-2
2013, Gasko FC , Jazeera SC ,0,1,-1,1,Loss,2,3,0,1,1,0,0,1.4285714285714286,1.7142857142857142,1.605263157894737,2.0789473684210527,,2.0,2.0,0.0,1.0,-1
2013, Albeder , ,1,1,0,0,Draw,0,1,0,0,0,0,1,1.0,1.5714285714285714,0.7272727272727273,2.9545454545454546,0.0,1.0,2.0,0.0,0.0,0
2013, Raadsan FC , Midnimo FC ,0,0,0,0,Draw,2,2,0,0,0,0,0,1.7407407407407407,1.4074074074074074,1.4878048780487805,1.2682926829268293,0.0,2.0,2.0,,,0
2013, Madbacadda FC , Gantaalaha Afgooye FC ,3,3,0,0,Draw,0,1,0,1,1,0,0,0.8,1.72,1.2857142857142858,1.8571428571428572,0.0,0.0,3.0,0.0,1.0,0
2013, Waxool FC , Jamhuuriya FC ,0,0,0,0,Draw,3,4,0,0,0,0,1,1.1142857142857143,2.142857142857143,1.6153846153846154,2.0,0.0,2.0,1.0,0.0,0.0,0
2013, SomaliFruit FC , Badbaado FC ,1,0,1,-1,Win,1,3,0,0,0,0,0,1.25,1.8125,0.8260869565217391,2.4347826086956523,1.0,1.0,1.0,,,1
2013, Bariga Dhexe , Geeska Afrika FC ,3,0,3,-3,Win,2,0,0,0,0,0,0,2.0,2.176470588235294,1.2173913043478262,2.5217391304347827,1.0,3.0,2.0,,,3
2013, Sahafi FC , Ummah Hospital ,4,2,2,-2,Win,4,0,0,1,1,0,0,1.6774193548387097,1.4516129032258065,1.0,1.2857142857142858,1.0,3.0,1.0,0.0,1.0,2
2013, Raadsan FC , ,6,1,5,-5,Win,2,0,0,0,0,0,0,1.7407407407407407,1.4074074074074074,0.7272727272727273,2.9545454545454546,1.0,3.0,3.0,,,5
2013, Madbacadda FC , Albeder ,1,2,-1,1,Loss,0,0,0,0,0,0,0,0.8,1.72,1.4285714285714286,1.5714285714285714,,0.0,0.0,,,-1
2013, Waxool FC , Jazeera SC ,1,1,0,0,Draw,3,3,0,0,0,0,0,1.1142857142857143,2.142857142857143,1.605263157894737,2.0789473684210527,0.0,2.0,1.0,,,0
2013, SomaliFruit FC , ,1,1,0,0,Draw,2,0,0,0,0,0,1,1.25,1.8125,0.7272727272727273,2.9545454545454546,0.0,1.0,2.0,0.0,0.0,0
2013, Bariga Dhexe , Midnimo FC ,6,0,6,-6,Win,2,2,0,1,1,0,0,2.0,2.176470588235294,1.4878048780487805,1.2682926829268293,1.0,3.0,3.0,0.0,1.0,6
2013, Sahafi FC , Gantaalaha Afgooye FC ,1,2,-1,1,Loss,5,1,0,0,0,0,0,1.6774193548387097,1.4516129032258065,1.2857142857142858,1.8571428571428572,,3.0,2.0,,,-1
2013, Geeska Afrika FC , Jamhuuriya FC ,1,3,-2,2,Loss,0,3,0,0,0,0,1,1.0434782608695652,2.9130434782608696,1.6153846153846154,2.0,,2.0,1.0,0.0,0.0,-2
2013, Ummah Hospital , Badbaado FC ,2,1,1,-1,Win,0,2,0,0,0,0,1,2.142857142857143,1.4285714285714286,0.8260869565217391,2.4347826086956523,1.0,4.0,2.0,0.0,0.0,1
2013, Waxool FC , Gasko FC ,3,1,2,-2,Win,2,2,0,0,0,0,0,1.1142857142857143,2.142857142857143,0.8571428571428571,2.357142857142857,1.0,3.0,5.0,,,2
2013, Albeder , SomaliFruit FC ,2,3,-1,1,Loss,1,2,0,0,0,0,1,1.0,1.5714285714285714,1.3333333333333333,1.6666666666666667,,0.0,1.0,0.0,0.0,-1
2013, Bariga Dhexe , ,10,1,9,-9,Win,3,0,0,0,0,0,0,2.0,2.176470588235294,0.7272727272727273,2.9545454545454546,1.0,3.0,3.0,,,9
2013, Geeska Afrika FC , Jazeera SC ,2,3,-1,1,Loss,0,3,0,0,0,0,1,1.0434782608695652,2.9130434782608696,1.605263157894737,2.0789473684210527,,1.0,1.0,0.0,0.0,-1
2013, Ummah Hospital , ,2,2,0,0,Draw,1,0,0,0,0,0,1,2.142857142857143,1.4285714285714286,0.7272727272727273,2.9545454545454546,0.0,3.0,2.0,0.0,0.0,0
2013, Jamhuuriya FC , Midnimo FC ,2,0,2,-2,Win,3,2,0,0,0,0,1,2.2666666666666666,1.2,1.4878048780487805,1.2682926829268293,1.0,2.0,3.0,0.0,0.0,2
2013, Badbaado FC , Gantaalaha Afgooye FC ,1,0,1,-1,Win,1,2,0,0,0,0,0,0.6521739130434783,2.9565217391304346,1.2857142857142858,1.8571428571428572,1.0,1.0,2.0,,,1
2013, Sahafi FC , Albeder ,3,1,2,-2,Win,4,1,0,0,0,0,0,1.6774193548387097,1.4516129032258065,1.4285714285714286,1.5714285714285714,1.0,3.0,1.0,,,2
2013, Bariga Dhexe , Raadsan FC ,2,1,1,-1,Win,3,2,0,0,0,0,0,2.0,2.176470588235294,1.59375,1.46875,1.0,4.0,2.0,,,1
2013, Ummah Hospital , SomaliFruit FC ,2,3,-1,1,Loss,1,3,0,0,0,0,1,2.142857142857143,1.4285714285714286,1.3333333333333333,1.6666666666666667,,2.0,1.0,0.0,0.0,-1
2013, Geeska Afrika FC , Gasko FC ,3,0,3,-3,Win,0,1,0,1,1,0,0,1.0434782608695652,2.9130434782608696,0.8571428571428571,2.357142857142857,1.0,1.0,5.0,0.0,1.0,3
2013, Badbaado FC , Madbacadda FC ,0,2,-2,2,Loss,2,0,0,0,0,0,0,0.6521739130434783,2.9565217391304346,0.9166666666666666,1.5833333333333333,,1.0,3.0,,,-2
2013, Jamhuuriya FC , ,8,0,8,-8,Win,3,0,0,0,0,0,0,2.2666666666666666,1.2,0.7272727272727273,2.9545454545454546,1.0,3.0,3.0,,,8
2013, Gantaalaha Afgooye FC , ,1,0,1,-1,Win,1,0,0,0,0,0,1,0.7142857142857143,1.0,0.7272727272727273,2.9545454545454546,1.0,2.0,3.0,0.0,0.0,1
2013, Midnimo FC , Jazeera SC ,2,2,0,0,Draw,2,3,0,1,1,0,0,1.4857142857142858,1.3714285714285714,1.605263157894737,2.0789473684210527,0.0,2.0,1.0,0.0,1.0,0
2013, Geeska Afrika FC , Waxool FC ,1,5,-4,4,Loss,1,2,0,0,0,0,1,1.0434782608695652,2.9130434782608696,1.4285714285714286,1.8571428571428572,,1.0,1.0,0.0,0.0,-4
2013, Jamhuuriya FC , Raadsan FC ,0,1,-1,1,Loss,4,2,0,0,0,0,0,2.2666666666666666,1.2,1.59375,1.46875,,2.0,2.0,,,-1
2013, Midnimo FC , Gasko FC ,2,2,0,0,Draw,1,0,0,0,0,0,1,1.4857142857142858,1.3714285714285714,0.8571428571428571,2.357142857142857,0.0,2.0,4.0,0.0,0.0,0
2013, Jazeera SC , ,3,0,3,-3,Win,3,0,0,0,0,0,0,1.205128205128205,2.230769230769231,0.7272727272727273,2.9545454545454546,1.0,3.0,4.0,,,3
2013, Jamhuuriya FC , Bariga Dhexe ,3,2,1,-1,Win,3,4,0,0,0,0,0,2.2666666666666666,1.2,1.1764705882352942,1.411764705882353,1.0,3.0,2.0,,,1
2013, Midnimo FC , Waxool FC ,1,3,-2,2,Loss,0,3,0,1,1,0,0,1.4857142857142858,1.3714285714285714,1.4285714285714286,1.8571428571428572,,1.0,1.0,0.0,1.0,-2
2013, Jazeera SC , Raadsan FC ,2,3,-1,1,Loss,3,2,0,1,1,0,0,1.205128205128205,2.230769230769231,1.59375,1.46875,,3.0,2.0,0.0,1.0,-1
2013, , Gasko FC ,0,1,-1,1,Loss,0,0,0,1,1,0,0,1.05,2.75,0.8571428571428571,2.357142857142857,,0.0,3.0,0.0,1.0,-1
2013, Heegan S.C , Gaadiidka FC ,3,2,1,-1,Win,4,0,0,0,0,0,0,1.5789473684210527,0.8947368421052632,1.588235294117647,1.5441176470588236,1.0,4.0,1.0,,,1
2013, Horseed S.C , Dekedda SC ,0,3,-3,3,Loss,1,1,1,0,0,1,1,1.5714285714285714,0.935064935064935,1.662162162162162,0.8648648648648649,,1.0,1.0,0.5,0.0,-3
2013, Jeenyo  FC , Batroolka FC ,2,0,2,-2,Win,4,0,0,0,0,0,0,1.4366197183098592,1.5211267605633803,0.8846153846153846,3.230769230769231,1.0,3.0,1.0,,,2
2013, Elman FC , Mogadishu City Club ,1,3,-2,2,Loss,4,0,0,0,0,0,1,1.8493150684931507,1.3287671232876712,1.96,0.7333333333333333,,2.0,1.0,0.0,0.0,-2
2013, Dekedda SC , Heegan S.C ,1,2,-1,1,Loss,2,4,0,0,0,0,1,1.7333333333333334,1.04,1.917808219178082,0.8767123287671232,,1.0,0.0,0.0,0.0,-1
2013, Gaadiidka FC , Batroolka FC ,1,0,1,-1,Win,0,0,0,0,0,0,0,1.2272727272727273,1.3333333333333333,0.8846153846153846,3.230769230769231,1.0,1.0,2.0,,,1
2013, Horseed S.C , Mogadishu City Club ,2,2,0,0,Draw,1,1,0,0,0,0,1,1.5714285714285714,0.935064935064935,1.96,0.7333333333333333,0.0,0.0,1.0,0.0,0.0,0
2014, Jeenyo  FC , Elman FC ,0,2,-2,2,Loss,4,3,0,0,0,0,1,1.4366197183098592,1.5211267605633803,1.75,1.144736842105263,,2.0,,0.0,0.0,-2
2014, Heegan S.C , Batroolka FC ,4,2,2,-2,Win,5,0,0,0,0,0,0,1.5789473684210527,0.8947368421052632,0.8846153846153846,3.230769230769231,1.0,4.0,3.0,,,2
2014, Dekedda SC , Mogadishu City Club ,2,4,-2,2,Loss,1,1,0,0,0,0,1,1.7333333333333334,1.04,1.96,0.7333333333333333,,1.0,1.0,0.0,0.0,-2
2014, Gaadiidka FC , Elman FC ,0,3,-3,3,Loss,1,3,0,0,0,0,0,1.2272727272727273,1.3333333333333333,1.75,1.144736842105263,,1.0,,,,-3
2014, Horseed S.C , Jeenyo  FC ,2,4,-2,2,Loss,1,3,0,0,0,0,1,1.5714285714285714,0.935064935064935,1.5846153846153845,1.4,,0.0,,0.0,0.0,-2
2014, Mogadishu City Club , Heegan S.C ,1,0,1,-1,Win,2,5,0,1,1,0,1,1.7671232876712328,0.9041095890410958,1.917808219178082,0.8767123287671232,1.0,1.0,1.0,0.0,0.5,1
2014, Batroolka FC , Elman FC ,1,2,-1,1,Loss,0,3,0,0,0,0,0,0.8333333333333334,3.0,1.75,1.144736842105263,,,,,,-1
2014, Dekedda SC , Jeenyo  FC ,0,3,-3,3,Loss,1,3,0,0,0,0,2,1.7333333333333334,1.04,1.5846153846153845,1.4,,0.0,,0.0,0.0,-3
2014, Gaadiidka FC , Horseed S.C ,2,2,0,0,Draw,1,1,0,0,0,0,0,1.2272727272727273,1.3333333333333333,1.4583333333333333,1.1805555555555556,0.0,1.0,2.0,,,0
2014, Heegan S.C , Elman FC ,1,2,-1,1,Loss,4,4,0,0,0,0,0,1.5789473684210527,0.8947368421052632,1.75,1.144736842105263,,3.0,,,,-1
2014, Mogadishu City Club , Jeenyo  FC ,1,1,0,0,Draw,3,4,0,1,1,0,1,1.7671232876712328,0.9041095890410958,1.5846153846153845,1.4,0.0,1.0,0.0,0.0,0.5,0
2014, Batroolka FC , Horseed S.C ,1,3,-2,2,Loss,0,0,0,0,0,0,0,0.8333333333333334,3.0,1.4583333333333333,1.1805555555555556,,,1.0,,,-2
2014, Dekedda SC , Gaadiidka FC ,1,1,0,0,Draw,1,1,0,0,0,0,0,1.7333333333333334,1.04,1.588235294117647,1.5441176470588236,0.0,0.0,1.0,,,0
2014, Jeenyo  FC , Heegan S.C ,0,1,-1,1,Loss,3,3,0,0,0,0,1,1.4366197183098592,1.5211267605633803,1.917808219178082,0.8767123287671232,,2.0,1.0,0.0,0.0,-1
2014, Elman FC , Horseed S.C ,3,3,0,0,Draw,4,1,1,0,0,1,0,1.8493150684931507,1.3287671232876712,1.4583333333333333,1.1805555555555556,0.0,1.0,0.0,1.0,0.0,0
2014, Mogadishu City Club , Gaadiidka FC ,3,2,1,-1,Win,3,1,0,0,0,0,0,1.7671232876712328,0.9041095890410958,1.588235294117647,1.5441176470588236,1.0,2.0,2.0,,,1
2014, Batroolka FC , Dekedda SC ,0,1,-1,1,Loss,0,1,0,0,0,0,0,0.8333333333333334,3.0,1.662162162162162,0.8648648648648649,,,0.0,,,-1
2014, Jeenyo  FC , Gaadiidka FC ,2,0,2,-2,Win,2,1,0,0,0,0,0,1.4366197183098592,1.5211267605633803,1.588235294117647,1.5441176470588236,1.0,3.0,3.0,,,2
2014, Heegan S.C , Horseed S.C ,3,0,3,-3,Win,3,1,1,0,0,1,1,1.5789473684210527,0.8947368421052632,1.4583333333333333,1.1805555555555556,1.0,4.0,1.0,0.5,0.0,3
2014, Elman FC , Dekedda SC ,2,0,2,-2,Win,4,1,1,0,0,1,0,1.8493150684931507,1.3287671232876712,1.662162162162162,0.8648648648648649,1.0,2.0,1.0,1.0,0.0,2
2014, Mogadishu City Club , Batroolka FC ,4,1,3,-3,Win,3,0,0,0,0,0,0,1.7671232876712328,0.9041095890410958,0.8846153846153846,3.230769230769231,1.0,3.0,4.0,,,3
2014, Gaadiidka FC , Heegan S.C ,1,2,-1,1,Loss,0,3,0,1,1,0,0,1.2272727272727273,1.3333333333333333,1.917808219178082,0.8767123287671232,,1.0,1.0,0.0,1.0,-1
2014, Dekedda SC , Horseed S.C ,0,1,-1,1,Loss,1,1,0,1,1,0,1,1.7333333333333334,1.04,1.4583333333333333,1.1805555555555556,,0.0,1.0,0.0,0.5,-1
2014, Jeenyo  FC , Batroolka FC ,1,1,0,0,Draw,3,0,1,0,0,1,0,1.4366197183098592,1.5211267605633803,0.8846153846153846,3.230769230769231,0.0,2.0,4.0,1.0,0.0,0
2014, Mogadishu City Club , Elman FC ,0,0,0,0,Draw,4,4,0,0,0,0,1,1.7671232876712328,0.9041095890410958,1.75,1.144736842105263,0.0,3.0,0.0,0.0,0.0,0
2014, Heegan S.C , Dekedda SC ,1,2,-1,1,Loss,3,1,0,0,0,0,1,1.5789473684210527,0.8947368421052632,1.662162162162162,0.8648648648648649,,3.0,1.0,0.0,0.0,-1
2014, Batroolka FC , Gaadiidka FC ,0,2,-2,2,Loss,0,0,0,1,1,0,0,0.8333333333333334,3.0,1.588235294117647,1.5441176470588236,,,3.0,0.0,1.0,-2
2014, Mogadishu City Club , Horseed S.C ,2,0,2,-2,Win,3,2,0,0,0,0,2,1.7671232876712328,0.9041095890410958,1.4583333333333333,1.1805555555555556,1.0,3.0,2.0,0.0,0.0,2
2014, Elman FC , Jeenyo  FC ,2,5,-3,3,Loss,3,2,0,0,0,0,1,1.8493150684931507,1.3287671232876712,1.5846153846153845,1.4,,1.0,0.0,0.0,0.0,-3
2014, Batroolka FC , Heegan S.C ,1,3,-2,2,Loss,0,3,0,1,1,0,0,0.8333333333333334,3.0,1.917808219178082,0.8767123287671232,,,1.0,0.0,1.0,-2
2014, Mogadishu City Club , Dekedda SC ,2,1,1,-1,Win,3,2,0,0,0,0,1,1.7671232876712328,0.9041095890410958,1.662162162162162,0.8648648648648649,1.0,4.0,2.0,0.0,0.0,1
2014, Elman FC , Gaadiidka FC ,3,1,2,-2,Win,2,1,0,0,0,0,0,1.8493150684931507,1.3287671232876712,1.588235294117647,1.5441176470588236,1.0,2.0,3.0,,,2
2014, Jeenyo  FC , Horseed S.C ,1,0,1,-1,Win,2,2,0,0,0,0,1,1.4366197183098592,1.5211267605633803,1.4583333333333333,1.1805555555555556,1.0,2.0,3.0,0.0,0.0,1
2014, Heegan S.C , Mogadishu City Club ,0,2,-2,2,Loss,4,4,1,1,1,1,1,1.5789473684210527,0.8947368421052632,1.96,0.7333333333333333,,2.0,1.0,0.3333333333333333,0.3333333333333333,-2
2014, Elman FC , Batroolka FC ,8,0,8,-8,Win,2,0,0,0,0,0,0,1.8493150684931507,1.3287671232876712,0.8846153846153846,3.230769230769231,1.0,3.0,4.0,,,8
2014, Jeenyo  FC , Dekedda SC ,1,1,0,0,Draw,3,2,0,0,0,0,2,1.4366197183098592,1.5211267605633803,1.662162162162162,0.8648648648648649,0.0,2.0,2.0,0.0,0.0,0
2014, Horseed S.C , Gaadiidka FC ,3,2,1,-1,Win,1,1,0,0,0,0,1,1.5714285714285714,0.935064935064935,1.588235294117647,1.5441176470588236,1.0,1.0,4.0,0.0,0.0,1
2014, Elman FC , Heegan S.C ,2,2,0,0,Draw,3,3,0,0,0,0,0,1.8493150684931507,1.3287671232876712,1.917808219178082,0.8767123287671232,0.0,3.0,1.0,,,0
2014, Jeenyo  FC , Mogadishu City Club ,1,1,0,0,Draw,3,4,1,0,0,1,2,1.4366197183098592,1.5211267605633803,1.96,0.7333333333333333,0.0,2.0,0.0,0.3333333333333333,0.0,0
2014, Horseed S.C , Batroolka FC ,6,1,5,-5,Win,2,0,0,0,0,0,0,1.5714285714285714,0.935064935064935,0.8846153846153846,3.230769230769231,1.0,2.0,4.0,,,5
2014, Gaadiidka FC , Dekedda SC ,0,0,0,0,Draw,1,1,0,0,0,0,1,1.2272727272727273,1.3333333333333333,1.662162162162162,0.8648648648648649,0.0,1.0,2.0,0.0,0.0,0
2014, Heegan S.C , Jeenyo  FC ,1,1,0,0,Draw,2,2,0,0,0,0,1,1.5789473684210527,0.8947368421052632,1.5846153846153845,1.4,0.0,1.0,0.0,0.0,0.0,0
2014, Horseed S.C , Elman FC ,1,1,0,0,Draw,3,2,0,1,1,0,1,1.5714285714285714,0.935064935064935,1.75,1.144736842105263,0.0,2.0,0.0,0.0,0.5,0
2014, Gaadiidka FC , Mogadishu City Club ,1,2,-1,1,Loss,1,3,0,1,1,0,0,1.2272727272727273,1.3333333333333333,1.96,0.7333333333333333,,0.0,0.0,0.0,1.0,-1
2014, Dekedda SC , Batroolka FC ,1,2,-1,1,Loss,1,0,0,0,0,0,0,1.7333333333333334,1.04,0.8846153846153846,3.230769230769231,,0.0,3.0,,,-1
2014, Horseed S.C , Heegan S.C ,3,3,0,0,Draw,2,1,0,2,2,0,1,1.5714285714285714,0.935064935064935,1.917808219178082,0.8767123287671232,0.0,2.0,0.0,0.0,0.6666666666666666,0
2014, Gaadiidka FC , Jeenyo  FC ,3,1,2,-2,Win,1,2,0,1,1,0,0,1.2272727272727273,1.3333333333333333,1.5846153846153845,1.4,1.0,1.0,1.0,0.0,1.0,2
2014, Dekedda SC , Elman FC ,0,3,-3,3,Loss,1,2,0,2,2,0,0,1.7333333333333334,1.04,1.75,1.144736842105263,,0.0,0.0,0.0,1.0,-3
2014, Batroolka FC , Mogadishu City Club ,1,7,-6,6,Loss,1,4,0,1,1,0,0,0.8333333333333334,3.0,1.96,0.7333333333333333,,,0.0,0.0,1.0,-6
2014, Geeska Afrika FC , Gasko FC ,0,1,-1,1,Loss,1,1,1,1,1,1,0,1.0434782608695652,2.9130434782608696,0.8571428571428571,2.357142857142857,,1.0,2.0,0.5,0.5,-1
2014, , Jazeera SC ,2,6,-4,4,Loss,0,2,0,1,1,0,0,1.05,2.75,1.605263157894737,2.0789473684210527,,,0.0,0.0,1.0,-4
2014, Jamhuuriya FC , Raadsan FC ,3,0,3,-3,Win,4,3,0,0,0,0,0,2.2666666666666666,1.2,1.59375,1.46875,1.0,4.0,3.0,,,3
2014, Midnimo FC , Gasko FC ,3,0,3,-3,Win,0,2,0,0,0,0,2,1.4857142857142858,1.3714285714285714,0.8571428571428571,2.357142857142857,1.0,2.0,2.0,0.0,0.0,3
2014, Geeska Afrika FC , Raadsan FC ,3,1,2,-2,Win,1,3,0,0,0,0,1,1.0434782608695652,2.9130434782608696,1.59375,1.46875,1.0,2.0,3.0,0.0,0.0,2
2014, Jamhuuriya FC , ,6,2,4,-4,Win,4,0,1,0,0,1,0,2.2666666666666666,1.2,0.7272727272727273,2.9545454545454546,1.0,4.0,4.0,1.0,0.0,4
2014, Jazeera SC , Midnimo FC ,2,3,-1,1,Loss,3,1,1,0,0,1,1,1.205128205128205,2.230769230769231,1.4878048780487805,1.2682926829268293,,2.0,2.0,0.5,0.0,-1
2014, Gasko FC , Raadsan FC ,0,4,-4,4,Loss,2,2,1,1,1,1,0,1.4285714285714286,1.7142857142857142,1.59375,1.46875,,1.0,2.0,0.5,0.5,-4
2014, Geeska Afrika FC , ,2,1,1,-1,Win,2,0,1,0,0,1,1,1.0434782608695652,2.9130434782608696,0.7272727272727273,2.9545454545454546,1.0,3.0,5.0,0.5,0.0,1
2014, Midnimo FC , Raadsan FC ,4,3,1,-1,Win,2,3,0,0,0,0,1,1.4857142857142858,1.3714285714285714,1.59375,1.46875,1.0,2.0,3.0,0.0,0.0,1
2014, Jazeera SC , Jamhuuriya FC ,1,2,-1,1,Loss,2,4,1,0,0,1,0,1.205128205128205,2.230769230769231,1.6153846153846154,2.0,,2.0,1.0,1.0,0.0,-1
2014, Gasko FC , ,1,0,1,-1,Win,2,0,1,0,0,1,0,1.4285714285714286,1.7142857142857142,0.7272727272727273,2.9545454545454546,1.0,1.0,5.0,1.0,0.0,1
2014, Jamhuuriya FC , Midnimo FC ,1,1,0,0,Draw,4,3,1,0,0,1,1,2.2666666666666666,1.2,1.4878048780487805,1.2682926829268293,0.0,3.0,2.0,0.5,0.0,0
2014, Raadsan FC , ,2,1,1,-1,Win,2,0,1,0,0,1,0,1.7407407407407407,1.4074074074074074,0.7272727272727273,2.9545454545454546,1.0,3.0,5.0,1.0,0.0,1
2014, Jazeera SC , Geeska Afrika FC ,3,2,1,-1,Win,2,3,0,0,0,0,1,1.205128205128205,2.230769230769231,1.2173913043478262,2.5217391304347827,1.0,2.0,3.0,0.0,0.0,1
2014, Midnimo FC , ,5,0,5,-5,Win,3,0,1,0,0,1,0,1.4857142857142858,1.3714285714285714,0.7272727272727273,2.9545454545454546,1.0,3.0,5.0,1.0,0.0,5
2014, Jamhuuriya FC , Geeska Afrika FC ,1,3,-2,2,Loss,4,2,0,0,0,0,1,2.2666666666666666,1.2,1.2173913043478262,2.5217391304347827,,3.0,2.0,0.0,0.0,-2
2014, Jazeera SC , Gasko FC ,2,0,2,-2,Win,2,3,1,0,0,1,0,1.205128205128205,2.230769230769231,0.8571428571428571,2.357142857142857,1.0,2.0,2.0,1.0,0.0,2
2014, Geeska Afrika FC , Midnimo FC ,3,2,1,-1,Win,3,4,1,1,1,1,0,1.0434782608695652,2.9130434782608696,1.4878048780487805,1.2682926829268293,1.0,3.0,3.0,0.5,0.5,1
2014, Jamhuuriya FC , Gasko FC ,3,1,2,-2,Win,3,2,1,0,0,1,0,2.2666666666666666,1.2,0.8571428571428571,2.357142857142857,1.0,3.0,3.0,1.0,0.0,2
2014, Raadsan FC , Jazeera SC ,1,2,-1,1,Loss,2,3,1,0,0,1,0,1.7407407407407407,1.4074074074074074,1.605263157894737,2.0789473684210527,,2.0,0.0,1.0,0.0,-1
2014, Gasko FC , Geeska Afrika FC ,2,1,1,-1,Win,1,4,1,1,1,1,0,1.4285714285714286,1.7142857142857142,1.2173913043478262,2.5217391304347827,1.0,2.0,3.0,0.5,0.5,1
2014, Jazeera SC , ,1,1,0,0,Draw,3,0,1,0,0,1,0,1.205128205128205,2.230769230769231,0.7272727272727273,2.9545454545454546,0.0,2.0,4.0,1.0,0.0,0
2014, Raadsan FC , Jamhuuriya FC ,3,2,1,-1,Win,2,3,0,1,1,0,0,1.7407407407407407,1.4074074074074074,1.6153846153846154,2.0,1.0,3.0,1.0,0.0,1.0,1
2014, Gasko FC , Midnimo FC ,0,5,-5,5,Loss,2,3,0,1,1,0,2,1.4285714285714286,1.7142857142857142,1.4878048780487805,1.2682926829268293,,2.0,2.0,0.0,0.3333333333333333,-5
2014, Raadsan FC , Geeska Afrika FC ,3,1,2,-2,Win,3,3,0,1,1,0,1,1.7407407407407407,1.4074074074074074,1.2173913043478262,2.5217391304347827,1.0,4.0,4.0,0.0,0.5,2
2014, Jamhuuriya FC , ,0,0,0,0,Draw,2,0,2,0,0,2,0,2.2666666666666666,1.2,0.7272727272727273,2.9545454545454546,0.0,2.0,3.0,1.0,0.0,0
2014, Midnimo FC , Jazeera SC ,2,2,0,0,Draw,3,3,0,1,1,0,1,1.4857142857142858,1.3714285714285714,1.605263157894737,2.0789473684210527,0.0,3.0,0.0,0.0,0.5,0
2014, Raadsan FC , Gasko FC ,3,2,1,-1,Win,3,2,1,1,1,1,0,1.7407407407407407,1.4074074074074074,0.8571428571428571,2.357142857142857,1.0,4.0,4.0,0.5,0.5,1
2014, , Geeska Afrika FC ,1,3,-2,2,Loss,0,2,0,2,2,0,1,1.05,2.75,1.2173913043478262,2.5217391304347827,,,3.0,0.0,0.6666666666666666,-2
2014, Raadsan FC , Midnimo FC ,1,7,-6,6,Loss,4,2,0,1,1,0,1,1.7407407407407407,1.4074074074074074,1.4878048780487805,1.2682926829268293,,3.0,1.0,0.0,0.5,-6
2014, Jamhuuriya FC , Jazeera SC ,2,3,-1,1,Loss,1,3,0,1,1,0,0,2.2666666666666666,1.2,1.605263157894737,2.0789473684210527,,1.0,0.0,0.0,1.0,-1
2014, , Gasko FC ,2,2,0,0,Draw,0,1,0,2,2,0,0,1.05,2.75,0.8571428571428571,2.357142857142857,0.0,0.0,4.0,0.0,1.0,0
2014, Midnimo FC , Jamhuuriya FC ,9,2,7,-7,Win,3,1,0,1,1,0,2,1.4857142857142858,1.3714285714285714,1.6153846153846154,2.0,1.0,4.0,2.0,0.0,0.3333333333333333,7
2014, , Raadsan FC ,3,4,-1,1,Loss,0,3,0,2,2,0,0,1.05,2.75,1.59375,1.46875,,0.0,3.0,0.0,1.0,-1
2014, Geeska Afrika FC , Jazeera SC ,1,3,-2,2,Loss,3,3,0,1,1,0,1,1.0434782608695652,2.9130434782608696,1.605263157894737,2.0789473684210527,,3.0,0.0,0.0,0.5,-2
2014, , Midnimo FC ,1,12,-11,11,Loss,0,3,0,2,2,0,0,1.05,2.75,1.4878048780487805,1.2682926829268293,,0.0,1.0,0.0,1.0,-11
2014, Geeska Afrika FC , Jamhuuriya FC ,2,1,1,-1,Win,2,1,0,0,0,0,1,1.0434782608695652,2.9130434782608696,1.6153846153846154,2.0,1.0,4.0,3.0,0.0,0.0,1
2014, Gasko FC , Jazeera SC ,0,1,-1,1,Loss,1,3,0,2,2,0,0,1.4285714285714286,1.7142857142857142,1.605263157894737,2.0789473684210527,,2.0,0.0,0.0,1.0,-1
2014, Midnimo FC , Geeska Afrika FC ,5,2,3,-3,Win,4,2,1,2,2,1,0,1.4857142857142858,1.3714285714285714,1.2173913043478262,2.5217391304347827,1.0,4.0,3.0,0.3333333333333333,0.6666666666666666,3
2014, Horseed S.C , Elman FC ,2,3,-1,1,Loss,2,3,0,1,1,0,2,1.5714285714285714,0.935064935064935,1.75,1.144736842105263,,2.0,0.0,0.0,0.3333333333333333,-1
2014, Gasko FC , Jamhuuriya FC ,4,1,3,-3,Win,1,0,0,2,2,0,0,1.4285714285714286,1.7142857142857142,1.6153846153846154,2.0,1.0,3.0,4.0,0.0,1.0,3
2014, Jazeera SC , Raadsan FC ,0,2,-2,2,Loss,3,4,0,1,1,0,0,1.205128205128205,2.230769230769231,1.59375,1.46875,,2.0,2.0,0.0,1.0,-2
2014, Jeenyo  FC , Heegan S.C ,1,3,-2,2,Loss,1,1,0,0,0,0,2,1.4366197183098592,1.5211267605633803,1.917808219178082,0.8767123287671232,,1.0,0.0,0.0,0.0,-2
2014, SomaliFruit FC , Dekedda SC ,3,1,2,-2,Win,3,0,0,0,0,0,0,1.25,1.8125,1.662162162162162,0.8648648648648649,1.0,2.0,2.0,,,2
2014, Mogadishu City Club , Gaadiidka FC ,1,1,0,0,Draw,4,1,1,0,0,1,0,1.7671232876712328,0.9041095890410958,1.588235294117647,1.5441176470588236,0.0,3.0,3.0,1.0,0.0,0
2014, Batroolka FC , Sahafi FC ,2,3,-1,1,Loss,1,4,0,0,0,0,0,0.8333333333333334,3.0,1.34375,1.34375,,,,,,-1
2014, Heegan S.C , Horseed S.C ,4,0,4,-4,Win,1,2,2,0,0,2,2,1.5789473684210527,0.8947368421052632,1.4583333333333333,1.1805555555555556,1.0,2.0,4.0,0.5,0.0,4
2014, Elman FC , Dekedda SC ,1,1,0,0,Draw,3,0,2,0,0,2,0,1.8493150684931507,1.3287671232876712,1.662162162162162,0.8648648648648649,0.0,2.0,2.0,1.0,0.0,0
2014, Jeenyo  FC , Gaadiidka FC ,4,2,2,-2,Win,0,1,1,1,1,1,0,1.4366197183098592,1.5211267605633803,1.588235294117647,1.5441176470588236,1.0,2.0,3.0,0.5,0.5,2
2015, Sahafi FC , SomaliFruit FC ,2,0,2,-2,Win,4,4,1,0,0,1,0,1.6774193548387097,1.4516129032258065,1.3333333333333333,1.6666666666666667,1.0,4.0,2.0,1.0,0.0,2
2015, Mogadishu City Club , Batroolka FC ,3,0,3,-3,Win,3,1,1,0,0,1,0,1.7671232876712328,0.9041095890410958,0.8846153846153846,3.230769230769231,1.0,3.0,3.0,1.0,0.0,3
2015, Horseed S.C , Dekedda SC ,0,1,-1,1,Loss,1,0,1,0,0,1,1,1.5714285714285714,0.935064935064935,1.662162162162162,0.8648648648648649,,1.0,1.0,0.5,0.0,-1
2015, Heegan S.C , Gaadiidka FC ,1,0,1,-1,Win,2,1,1,0,0,1,0,1.5789473684210527,0.8947368421052632,1.588235294117647,1.5441176470588236,1.0,2.0,4.0,1.0,0.0,1
2015, Elman FC , Sahafi FC ,0,2,-2,2,Loss,2,4,1,0,0,1,0,1.8493150684931507,1.3287671232876712,1.34375,1.34375,,2.0,,1.0,0.0,-2
2015, Jeenyo  FC , Batroolka FC ,4,1,3,-3,Win,1,1,1,0,0,1,1,1.4366197183098592,1.5211267605633803,0.8846153846153846,3.230769230769231,1.0,2.0,4.0,0.5,0.0,3
2015, SomaliFruit FC , Mogadishu City Club ,1,2,-1,1,Loss,3,3,0,0,0,0,0,1.25,1.8125,1.96,0.7333333333333333,,2.0,0.0,,,-1
2015, Gaadiidka FC , Horseed S.C ,0,1,-1,1,Loss,1,0,0,1,1,0,1,1.2272727272727273,1.3333333333333333,1.4583333333333333,1.1805555555555556,,1.0,3.0,0.0,0.5,-1
2015, Dekedda SC , Sahafi FC ,2,1,1,-1,Win,1,4,0,0,0,0,2,1.7333333333333334,1.04,1.34375,1.34375,1.0,1.0,1.0,0.0,0.0,1
2015, Batroolka FC , Heegan S.C ,0,4,-4,4,Loss,1,3,0,1,1,0,0,0.8333333333333334,3.0,1.917808219178082,0.8767123287671232,,,0.0,0.0,1.0,-4
2015, Mogadishu City Club , Elman FC ,1,1,0,0,Draw,4,2,0,0,0,0,2,1.7671232876712328,0.9041095890410958,1.75,1.144736842105263,0.0,3.0,0.0,0.0,0.0,0
2015, Jeenyo  FC , SomaliFruit FC ,5,0,5,-5,Win,2,3,0,0,0,0,0,1.4366197183098592,1.5211267605633803,1.3333333333333333,1.6666666666666667,1.0,3.0,2.0,,,5
2015, Horseed S.C , Sahafi FC ,2,1,1,-1,Win,1,4,0,0,0,0,2,1.5714285714285714,0.935064935064935,1.34375,1.34375,1.0,1.0,2.0,0.0,0.0,1
2015, Gaadiidka FC , Batroolka FC ,3,0,3,-3,Win,1,0,1,0,0,1,0,1.2272727272727273,1.3333333333333333,0.8846153846153846,3.230769230769231,1.0,2.0,4.0,1.0,0.0,3
2015, Dekedda SC , Mogadishu City Club ,0,2,-2,2,Loss,2,3,0,1,1,0,1,1.7333333333333334,1.04,1.96,0.7333333333333333,,1.0,0.0,0.0,0.5,-2
2015, SomaliFruit FC , Heegan S.C ,1,8,-7,7,Loss,2,4,0,0,0,0,0,1.25,1.8125,1.917808219178082,0.8767123287671232,,2.0,0.0,,,-7
2015, Elman FC , Jeenyo  FC ,1,1,0,0,Draw,2,3,0,0,0,0,1,1.8493150684931507,1.3287671232876712,1.5846153846153845,1.4,0.0,1.0,1.0,0.0,0.0,0
2015, Batroolka FC , Horseed S.C ,2,2,0,0,Draw,0,2,0,1,1,0,0,0.8333333333333334,3.0,1.4583333333333333,1.1805555555555556,0.0,0.0,3.0,0.0,1.0,0
2015, Sahafi FC , Mogadishu City Club ,0,0,0,0,Draw,3,3,0,1,1,0,1,1.6774193548387097,1.4516129032258065,1.96,0.7333333333333333,0.0,3.0,0.0,0.0,0.5,0
2015, Dekedda SC , Jeenyo  FC ,0,1,-1,1,Loss,2,3,0,0,0,0,3,1.7333333333333334,1.04,1.5846153846153845,1.4,,1.0,1.0,0.0,0.0,-1
2015, Elman FC , Heegan S.C ,1,0,1,-1,Win,1,5,0,0,0,0,1,1.8493150684931507,1.3287671232876712,1.917808219178082,0.8767123287671232,1.0,1.0,1.0,0.0,0.0,1
2015, Horseed S.C , Mogadishu City Club ,0,2,-2,2,Loss,2,3,0,1,1,0,2,1.5714285714285714,0.935064935064935,1.96,0.7333333333333333,,1.0,0.0,0.0,0.3333333333333333,-2
2015, Batroolka FC , SomaliFruit FC ,1,2,-1,1,Loss,0,1,0,0,0,0,0,0.8333333333333334,3.0,1.3333333333333333,1.6666666666666667,,0.0,2.0,,,-1
2015, Sahafi FC , Jeenyo  FC ,0,0,0,0,Draw,2,4,0,0,0,0,2,1.6774193548387097,1.4516129032258065,1.5846153846153845,1.4,0.0,2.0,1.0,0.0,0.0,0
2015, Gaadiidka FC , Elman FC ,0,0,0,0,Draw,1,1,0,1,1,0,0,1.2272727272727273,1.3333333333333333,1.75,1.144736842105263,0.0,2.0,0.0,0.0,1.0,0
2015, Dekedda SC , Heegan S.C ,0,2,-2,2,Loss,2,4,0,0,0,0,1,1.7333333333333334,1.04,1.917808219178082,0.8767123287671232,,1.0,1.0,0.0,0.0,-2
2015, SomaliFruit FC , Horseed S.C ,2,0,2,-2,Win,1,2,0,0,0,0,0,1.25,1.8125,1.4583333333333333,1.1805555555555556,1.0,2.0,3.0,,,2
2015, Batroolka FC , Elman FC ,1,3,-2,2,Loss,0,1,0,1,1,0,0,0.8333333333333334,3.0,1.75,1.144736842105263,,0.0,0.0,0.0,1.0,-2
2015, Mogadishu City Club , Jeenyo  FC ,0,3,-3,3,Loss,3,3,0,1,1,0,3,1.7671232876712328,0.9041095890410958,1.5846153846153845,1.4,,2.0,1.0,0.0,0.25,-3
2015, Sahafi FC , Heegan S.C ,3,3,0,0,Draw,1,4,0,1,1,0,0,1.6774193548387097,1.4516129032258065,1.917808219178082,0.8767123287671232,0.0,2.0,1.0,0.0,1.0,0
2015, Gaadiidka FC , Dekedda SC ,0,1,-1,1,Loss,1,2,0,0,0,0,2,1.2272727272727273,1.3333333333333333,1.662162162162162,0.8648648648648649,,2.0,1.0,0.0,0.0,-1
2015, Horseed S.C , Jeenyo  FC ,0,1,-1,1,Loss,2,3,0,1,1,0,1,1.5714285714285714,0.935064935064935,1.5846153846153845,1.4,,1.0,0.0,0.0,0.5,-1
2015, SomaliFruit FC , Elman FC ,0,2,-2,2,Loss,2,2,0,0,0,0,0,1.25,1.8125,1.75,1.144736842105263,,2.0,0.0,,,-2
2015, Mogadishu City Club , Heegan S.C ,0,0,0,0,Draw,2,3,1,1,1,1,1,1.7671232876712328,0.9041095890410958,1.917808219178082,0.8767123287671232,0.0,1.0,1.0,0.3333333333333333,0.3333333333333333,0
2015, Batroolka FC , Dekedda SC ,0,4,-4,4,Loss,0,2,0,0,0,0,0,0.8333333333333334,3.0,1.662162162162162,0.8648648648648649,,0.0,1.0,,,-4
2015, Sahafi FC , Gaadiidka FC ,0,1,-1,1,Loss,0,1,0,0,0,0,0,1.6774193548387097,1.4516129032258065,1.588235294117647,1.5441176470588236,,1.0,3.0,,,-1
2015, Elman FC , Horseed S.C ,3,0,3,-3,Win,3,1,1,0,0,1,2,1.8493150684931507,1.3287671232876712,1.4583333333333333,1.1805555555555556,1.0,2.0,3.0,0.3333333333333333,0.0,3
2015, Heegan S.C , Jeenyo  FC ,2,0,2,-2,Win,2,3,0,0,0,0,2,1.5789473684210527,0.8947368421052632,1.5846153846153845,1.4,1.0,3.0,1.0,0.0,0.0,2
2015, Dekedda SC , SomaliFruit FC ,0,1,-1,1,Loss,2,2,0,1,1,0,0,1.7333333333333334,1.04,1.3333333333333333,1.6666666666666667,,1.0,2.0,0.0,1.0,-1
2015, Gaadiidka FC , Mogadishu City Club ,2,1,1,-1,Win,2,2,0,1,1,0,1,1.2272727272727273,1.3333333333333333,1.96,0.7333333333333333,1.0,2.0,1.0,0.0,0.5,1
2015, Sahafi FC , Batroolka FC ,7,0,7,-7,Win,0,0,0,0,0,0,0,1.6774193548387097,1.4516129032258065,0.8846153846153846,3.230769230769231,1.0,1.0,4.0,,,7
2015, Horseed S.C , Heegan S.C ,1,0,1,-1,Win,0,2,0,3,3,0,2,1.5714285714285714,0.935064935064935,1.917808219178082,0.8767123287671232,1.0,2.0,2.0,0.0,0.6,1
2015, Dekedda SC , Elman FC ,2,0,2,-2,Win,2,4,0,2,2,0,1,1.7333333333333334,1.04,1.75,1.144736842105263,1.0,1.0,1.0,0.0,0.6666666666666666,2
2015, Gaadiidka FC , Jeenyo  FC ,4,2,2,-2,Win,3,3,1,2,2,1,0,1.2272727272727273,1.3333333333333333,1.5846153846153845,1.4,1.0,3.0,2.0,0.3333333333333333,0.6666666666666666,2
2015, SomaliFruit FC , Sahafi FC ,1,4,-3,3,Loss,3,1,0,2,2,0,0,1.25,1.8125,1.34375,1.34375,,1.0,2.0,0.0,1.0,-3
2015, Dekedda SC , Horseed S.C ,4,0,4,-4,Win,3,1,0,1,1,0,1,1.7333333333333334,1.04,1.4583333333333333,1.1805555555555556,1.0,2.0,3.0,0.0,0.5,4
2015, Gaadiidka FC , Heegan S.C ,0,1,-1,1,Loss,3,2,0,2,2,0,0,1.2272727272727273,1.3333333333333333,1.917808219178082,0.8767123287671232,,2.0,1.0,0.0,1.0,-1
2015, Sahafi FC , Elman FC ,1,3,-2,2,Loss,2,3,0,1,1,0,0,1.6774193548387097,1.4516129032258065,1.75,1.144736842105263,,1.0,1.0,0.0,1.0,-2
2015, Mogadishu City Club , SomaliFruit FC ,2,0,2,-2,Win,1,3,0,0,0,0,0,1.7671232876712328,0.9041095890410958,1.3333333333333333,1.6666666666666667,1.0,2.0,3.0,,,2
2015, Batroolka FC , Jeenyo  FC ,1,8,-7,7,Loss,0,2,0,2,2,0,1,0.8333333333333334,3.0,1.5846153846153845,1.4,,0.0,2.0,0.0,0.6666666666666666,-7
2015, Horseed S.C , Gaadiidka FC ,1,3,-2,2,Loss,1,3,1,0,0,1,1,1.5714285714285714,0.935064935064935,1.588235294117647,1.5441176470588236,,2.0,2.0,0.5,0.0,-2
2015, Sahafi FC , Dekedda SC ,1,3,-2,2,Loss,2,4,0,1,1,0,2,1.6774193548387097,1.4516129032258065,1.662162162162162,0.8648648648648649,,1.0,0.0,0.0,0.3333333333333333,-2
2015, Heegan S.C , Batroolka FC ,4,1,3,-3,Win,2,0,1,0,0,1,0,1.5789473684210527,0.8947368421052632,0.8846153846153846,3.230769230769231,1.0,4.0,5.0,1.0,0.0,3
2015, Elman FC , Mogadishu City Club ,0,0,0,0,Draw,4,2,0,0,0,0,3,1.8493150684931507,1.3287671232876712,1.96,0.7333333333333333,0.0,2.0,1.0,0.0,0.0,0
2015, SomaliFruit FC , Jeenyo  FC ,1,1,0,0,Draw,2,3,0,1,1,0,0,1.25,1.8125,1.5846153846153845,1.4,0.0,1.0,2.0,0.0,1.0,0
2015, Sahafi FC , Horseed S.C ,0,0,0,0,Draw,2,1,0,1,1,0,2,1.6774193548387097,1.4516129032258065,1.4583333333333333,1.1805555555555556,0.0,1.0,3.0,0.0,0.3333333333333333,0
2015, Batroolka FC , Gaadiidka FC ,0,0,0,0,Draw,0,4,0,2,2,0,0,0.8333333333333334,3.0,1.588235294117647,1.5441176470588236,0.0,0.0,2.0,0.0,1.0,0
2015, Batroolka FC , Mogadishu City Club ,1,5,-4,4,Loss,0,1,0,2,2,0,0,0.8333333333333334,3.0,1.96,0.7333333333333333,,0.0,1.0,0.0,1.0,-4
2015, Mogadishu City Club , Dekedda SC ,0,1,-1,1,Loss,2,4,1,0,0,1,1,1.7671232876712328,0.9041095890410958,1.662162162162162,0.8648648648648649,,1.0,,0.5,0.0,-1
2015, Heegan S.C , SomaliFruit FC ,3,0,3,-3,Win,3,1,0,0,0,0,0,1.5789473684210527,0.8947368421052632,1.3333333333333333,1.6666666666666667,1.0,5.0,3.0,,,3
2015, Jeenyo  FC , Elman FC ,0,0,0,0,Draw,2,3,0,0,0,0,2,1.4366197183098592,1.5211267605633803,1.75,1.144736842105263,0.0,3.0,1.0,0.0,0.0,0
2015, Horseed S.C , Batroolka FC ,3,1,2,-2,Win,1,0,1,0,0,1,1,1.5714285714285714,0.935064935064935,0.8846153846153846,3.230769230769231,1.0,2.0,5.0,0.5,0.0,2
2015, Mogadishu City Club , Sahafi FC ,3,0,3,-3,Win,2,2,1,0,0,1,2,1.7671232876712328,0.9041095890410958,1.34375,1.34375,1.0,2.0,3.0,0.3333333333333333,0.0,3
2015, SomaliFruit FC , Gaadiidka FC ,1,0,1,-1,Win,1,3,0,0,0,0,0,1.25,1.8125,1.588235294117647,1.5441176470588236,1.0,2.0,2.0,,,1
2015, Jeenyo  FC , Dekedda SC ,3,0,3,-3,Win,1,4,0,0,0,0,3,1.4366197183098592,1.5211267605633803,1.662162162162162,0.8648648648648649,1.0,4.0,1.0,0.0,0.0,3
2015, Heegan S.C , Elman FC ,1,1,0,0,Draw,4,2,0,1,1,0,1,1.5789473684210527,0.8947368421052632,1.75,1.144736842105263,0.0,4.0,1.0,0.0,0.5,0
2015, Mogadishu City Club , Horseed S.C ,5,0,5,-5,Win,3,2,1,0,0,1,2,1.7671232876712328,0.9041095890410958,1.4583333333333333,1.1805555555555556,1.0,3.0,4.0,0.3333333333333333,0.0,5
2015, SomaliFruit FC , Batroolka FC ,1,2,-1,1,Loss,1,0,0,0,0,0,0,1.25,1.8125,0.8846153846153846,3.230769230769231,,1.0,4.0,,,-1
2015, Jeenyo  FC , Sahafi FC ,2,1,1,-1,Win,2,1,0,0,0,0,3,1.4366197183098592,1.5211267605633803,1.34375,1.34375,1.0,4.0,4.0,0.0,0.0,1
2015, Elman FC , Gaadiidka FC ,0,2,-2,2,Loss,1,2,1,0,0,1,1,1.8493150684931507,1.3287671232876712,1.588235294117647,1.5441176470588236,,2.0,1.0,0.5,0.0,-2
2015, Heegan S.C , Dekedda SC ,2,0,2,-2,Win,3,4,0,0,0,0,1,1.5789473684210527,0.8947368421052632,1.662162162162162,0.8648648648648649,1.0,4.0,2.0,0.0,0.0,2
2015, Horseed S.C , SomaliFruit FC ,2,0,2,-2,Win,1,1,0,1,1,0,0,1.5714285714285714,0.935064935064935,1.3333333333333333,1.6666666666666667,1.0,3.0,3.0,0.0,1.0,2
2015, Jeenyo  FC , Mogadishu City Club ,1,2,-1,1,Loss,3,3,1,0,0,1,3,1.4366197183098592,1.5211267605633803,1.96,0.7333333333333333,,3.0,1.0,0.25,0.0,-1
2015, Elman FC , Batroolka FC ,4,2,2,-2,Win,1,1,1,0,0,1,0,1.8493150684931507,1.3287671232876712,0.8846153846153846,3.230769230769231,1.0,3.0,4.0,1.0,0.0,2
2015, Heegan S.C , Sahafi FC ,0,1,-1,1,Loss,4,0,1,0,0,1,1,1.5789473684210527,0.8947368421052632,1.34375,1.34375,,3.0,3.0,0.5,0.0,-1
2015, Dekedda SC , Gaadiidka FC ,2,0,2,-2,Win,3,2,0,0,0,0,2,1.7333333333333334,1.04,1.588235294117647,1.5441176470588236,1.0,3.0,2.0,0.0,0.0,2
2015, Jeenyo  FC , Horseed S.C ,2,1,1,-1,Win,2,2,1,0,0,1,1,1.4366197183098592,1.5211267605633803,1.4583333333333333,1.1805555555555556,1.0,3.0,4.0,0.5,0.0,1
2015, Elman FC , SomaliFruit FC ,2,2,0,0,Draw,1,1,0,0,0,0,0,1.8493150684931507,1.3287671232876712,1.3333333333333333,1.6666666666666667,0.0,2.0,3.0,,,0
2015, Heegan S.C , Mogadishu City Club ,0,2,-2,2,Loss,3,4,1,1,1,1,2,1.5789473684210527,0.8947368421052632,1.96,0.7333333333333333,,2.0,1.0,0.25,0.25,-2
2015, Dekedda SC , Batroolka FC ,5,1,4,-4,Win,3,1,0,0,0,0,0,1.7333333333333334,1.04,0.8846153846153846,3.230769230769231,1.0,4.0,4.0,,,4
2015, Gaadiidka FC , Sahafi FC ,2,1,1,-1,Win,2,1,0,0,0,0,0,1.2272727272727273,1.3333333333333333,1.34375,1.34375,1.0,3.0,3.0,,,1
2015, Dekedda SC , Heegan S.C ,1,0,1,-1,Win,3,2,0,1,1,0,1,1.7333333333333334,1.04,1.917808219178082,0.8767123287671232,1.0,5.0,2.0,0.0,0.5,1
2015, Mogadishu City Club , Waxool FC ,1,0,1,-1,Win,4,3,0,0,0,0,0,1.7671232876712328,0.9041095890410958,1.4285714285714286,1.8571428571428572,1.0,4.0,2.0,,,1
2015, Jeenyo  FC , Horseed S.C ,1,1,0,0,Draw,3,2,2,0,0,2,1,1.4366197183098592,1.5211267605633803,1.4583333333333333,1.1805555555555556,0.0,3.0,3.0,0.6666666666666666,0.0,0
2015, Gaadiidka FC , Sahafi FC ,1,1,0,0,Draw,2,1,1,0,0,1,0,1.2272727272727273,1.3333333333333333,1.34375,1.34375,0.0,3.0,3.0,1.0,0.0,0
2016, Elman FC , Badbaado FC ,1,1,0,0,Draw,1,2,1,0,0,1,0,1.8493150684931507,1.3287671232876712,0.8260869565217391,2.4347826086956523,0.0,1.0,2.0,1.0,0.0,0
2016, Waxool FC , Dekedda SC ,0,0,0,0,Draw,3,3,0,0,0,0,0,1.1142857142857143,2.142857142857143,1.662162162162162,0.8648648648648649,0.0,2.0,2.0,,,0
2016, Heegan S.C , Horseed S.C ,2,2,0,0,Draw,1,2,3,1,1,3,2,1.5789473684210527,0.8947368421052632,1.4583333333333333,1.1805555555555556,0.0,1.0,2.0,0.5,0.16666666666666666,0
2016, Mogadishu City Club , Sahafi FC ,1,0,1,-1,Win,5,1,2,0,0,2,2,1.7671232876712328,0.9041095890410958,1.34375,1.34375,1.0,4.0,3.0,0.5,0.0,1
2016, Jeenyo  FC , Badbaado FC ,4,1,3,-3,Win,3,1,1,0,0,1,0,1.4366197183098592,1.5211267605633803,0.8260869565217391,2.4347826086956523,1.0,3.0,3.0,1.0,0.0,3
2016, Gaadiidka FC , Elman FC ,0,1,-1,1,Loss,2,1,0,1,1,0,1,1.2272727272727273,1.3333333333333333,1.75,1.144736842105263,,2.0,1.0,0.0,0.5,-1
2016, Dekedda SC , Horseed S.C ,2,0,2,-2,Win,3,1,1,1,1,1,1,1.7333333333333334,1.04,1.4583333333333333,1.1805555555555556,1.0,5.0,3.0,0.3333333333333333,0.3333333333333333,2
2016, Waxool FC , Sahafi FC ,2,1,1,-1,Win,3,1,0,0,0,0,0,1.1142857142857143,2.142857142857143,1.34375,1.34375,1.0,2.0,3.0,,,1
2016, Heegan S.C , Badbaado FC ,1,0,1,-1,Win,1,1,1,0,0,1,0,1.5789473684210527,0.8947368421052632,0.8260869565217391,2.4347826086956523,1.0,2.0,4.0,1.0,0.0,1
2016, Mogadishu City Club , Elman FC ,2,1,1,-1,Win,5,2,0,0,0,0,4,1.7671232876712328,0.9041095890410958,1.75,1.144736842105263,1.0,5.0,1.0,0.0,0.0,1
2016, Jeenyo  FC , Gaadiidka FC ,1,1,0,0,Draw,3,2,2,2,2,2,0,1.4366197183098592,1.5211267605633803,1.588235294117647,1.5441176470588236,0.0,2.0,2.0,0.5,0.5,0
2016, Sahafi FC , Dekedda SC ,1,4,-3,3,Loss,1,4,0,1,1,0,2,1.6774193548387097,1.4516129032258065,1.662162162162162,0.8648648648648649,,1.0,2.0,0.0,0.3333333333333333,-3
2016, Horseed S.C , Badbaado FC ,2,0,2,-2,Win,1,1,1,0,0,1,0,1.5714285714285714,0.935064935064935,0.8260869565217391,2.4347826086956523,1.0,4.0,4.0,1.0,0.0,2
2016, Waxool FC , Elman FC ,0,4,-4,4,Loss,3,2,0,0,0,0,0,1.1142857142857143,2.142857142857143,1.75,1.144736842105263,,2.0,1.0,,,-4
2016, Heegan S.C , Gaadiidka FC ,0,1,-1,1,Loss,1,1,2,0,0,2,0,1.5789473684210527,0.8947368421052632,1.588235294117647,1.5441176470588236,,1.0,2.0,1.0,0.0,-1
2016, Mogadishu City Club , Jeenyo  FC ,2,0,2,-2,Win,5,2,0,1,1,0,3,1.7671232876712328,0.9041095890410958,1.5846153846153845,1.4,1.0,5.0,3.0,0.0,0.25,2
2016, Dekedda SC , Badbaado FC ,2,2,0,0,Draw,4,0,1,0,0,1,0,1.7333333333333334,1.04,0.8260869565217391,2.4347826086956523,0.0,4.0,3.0,1.0,0.0,0
2016, Sahafi FC , Elman FC ,2,0,2,-2,Win,0,2,0,1,1,0,0,1.6774193548387097,1.4516129032258065,1.75,1.144736842105263,1.0,1.0,2.0,0.0,1.0,2
2016, Horseed S.C , Gaadiidka FC ,0,2,-2,2,Loss,1,2,1,0,0,1,1,1.5714285714285714,0.935064935064935,1.588235294117647,1.5441176470588236,,3.0,1.0,0.5,0.0,-2
2016, Waxool FC , Jeenyo  FC ,1,2,-1,1,Loss,2,2,0,0,0,0,0,1.1142857142857143,2.142857142857143,1.5846153846153845,1.4,,2.0,2.0,,,-1
2016, Heegan S.C , Mogadishu City Club ,0,0,0,0,Draw,1,5,1,1,1,1,2,1.5789473684210527,0.8947368421052632,1.96,0.7333333333333333,0.0,1.0,0.0,0.25,0.25,0
2016, Elman FC , Dekedda SC ,0,1,-1,1,Loss,2,3,2,1,1,2,1,1.8493150684931507,1.3287671232876712,1.662162162162162,0.8648648648648649,,1.0,2.0,0.5,0.25,-1
2016, Badbaado FC , Gaadiidka FC ,0,2,-2,2,Loss,0,2,0,0,0,0,0,0.6521739130434783,2.9565217391304346,1.588235294117647,1.5441176470588236,,1.0,1.0,,,-2
2016, Sahafi FC , Jeenyo  FC ,1,3,-2,2,Loss,1,2,0,1,1,0,3,1.6774193548387097,1.4516129032258065,1.5846153846153845,1.4,,1.0,1.0,0.0,0.25,-2
2016, Horseed S.C , Mogadishu City Club ,0,0,0,0,Draw,1,4,0,2,2,0,2,1.5714285714285714,0.935064935064935,1.96,0.7333333333333333,0.0,3.0,0.0,0.0,0.5,0
2016, Waxool FC , Heegan S.C ,0,2,-2,2,Loss,1,1,0,0,0,0,0,1.1142857142857143,2.142857142857143,1.917808219178082,0.8767123287671232,,1.0,2.0,,,-2
2016, Dekedda SC , Gaadiidka FC ,1,1,0,0,Draw,3,3,1,0,0,1,2,1.7333333333333334,1.04,1.588235294117647,1.5441176470588236,0.0,3.0,0.0,0.3333333333333333,0.0,0
2016, Elman FC , Jeenyo  FC ,1,1,0,0,Draw,2,3,0,0,0,0,3,1.8493150684931507,1.3287671232876712,1.5846153846153845,1.4,0.0,1.0,1.0,0.0,0.0,0
2016, Badbaado FC , Mogadishu City Club ,0,6,-6,6,Loss,0,3,0,0,0,0,1,0.6521739130434783,2.9565217391304346,1.96,0.7333333333333333,,1.0,0.0,0.0,0.0,-6
2016, Sahafi FC , Heegan S.C ,0,2,-2,2,Loss,1,2,0,1,1,0,1,1.6774193548387097,1.4516129032258065,1.917808219178082,0.8767123287671232,,1.0,2.0,0.0,0.5,-2
2016, Horseed S.C , Waxool FC ,3,1,2,-2,Win,1,1,0,0,0,0,0,1.5714285714285714,0.935064935064935,1.4285714285714286,1.8571428571428572,1.0,3.0,3.0,,,2
2016, Jeenyo  FC , Dekedda SC ,3,1,2,-2,Win,2,3,1,0,0,1,3,1.4366197183098592,1.5211267605633803,1.662162162162162,0.8648648648648649,1.0,3.0,2.0,0.25,0.0,2
2016, Gaadiidka FC , Mogadishu City Club ,0,2,-2,2,Loss,3,3,1,1,1,1,1,1.2272727272727273,1.3333333333333333,1.96,0.7333333333333333,,1.0,0.0,0.3333333333333333,0.3333333333333333,-2
2016, Elman FC , Heegan S.C ,1,1,0,0,Draw,1,3,1,0,0,1,2,1.8493150684931507,1.3287671232876712,1.917808219178082,0.8767123287671232,0.0,0.0,1.0,0.3333333333333333,0.0,0
2016, Badbaado FC , Waxool FC ,1,4,-3,3,Loss,0,1,0,0,0,0,0,0.6521739130434783,2.9565217391304346,1.4285714285714286,1.8571428571428572,,1.0,2.0,,,-3
2016, Sahafi FC , Horseed S.C ,2,3,-1,1,Loss,1,2,0,1,1,0,3,1.6774193548387097,1.4516129032258065,1.4583333333333333,1.1805555555555556,,1.0,2.0,0.0,0.25,-1
2016, Dekedda SC , Mogadishu City Club ,1,1,0,0,Draw,2,3,0,1,1,0,1,1.7333333333333334,1.04,1.96,0.7333333333333333,0.0,2.0,0.0,0.0,0.5,0
2016, Jeenyo  FC , Heegan S.C ,2,2,0,0,Draw,3,2,0,1,1,0,2,1.4366197183098592,1.5211267605633803,1.917808219178082,0.8767123287671232,0.0,2.0,1.0,0.0,0.3333333333333333,0
2016, Gaadiidka FC , Waxool FC ,2,1,1,-1,Win,3,1,0,0,0,0,0,1.2272727272727273,1.3333333333333333,1.4285714285714286,1.8571428571428572,1.0,2.0,3.0,,,1
2016, Elman FC , Horseed S.C ,0,3,-3,3,Loss,1,3,2,0,0,2,2,1.8493150684931507,1.3287671232876712,1.4583333333333333,1.1805555555555556,,0.0,1.0,0.5,0.0,-3
2016, Badbaado FC , Sahafi FC ,2,3,-1,1,Loss,0,1,0,2,2,0,0,0.6521739130434783,2.9565217391304346,1.34375,1.34375,,,3.0,0.0,1.0,-1
2016, Heegan S.C , Dekedda SC ,3,0,3,-3,Win,2,1,1,1,1,1,1,1.5789473684210527,0.8947368421052632,1.662162162162162,0.8648648648648649,1.0,2.0,2.0,0.3333333333333333,0.3333333333333333,3
2016, Waxool FC , Mogadishu City Club ,1,2,-1,1,Loss,1,2,0,1,1,0,0,1.1142857142857143,2.142857142857143,1.96,0.7333333333333333,,1.0,0.0,0.0,1.0,-1
2016, Horseed S.C , Jeenyo  FC ,1,3,-2,2,Loss,3,3,0,2,2,0,2,1.5714285714285714,0.935064935064935,1.5846153846153845,1.4,,2.0,1.0,0.0,0.5,-2
2016, Sahafi FC , Gaadiidka FC ,1,1,0,0,Draw,2,3,0,1,1,0,1,1.6774193548387097,1.4516129032258065,1.588235294117647,1.5441176470588236,0.0,1.0,0.0,0.0,0.5,0
2016, Badbaado FC , Elman FC ,1,2,-1,1,Loss,0,0,0,1,1,0,1,0.6521739130434783,2.9565217391304346,1.75,1.144736842105263,,,2.0,0.0,0.5,-1
2016, Dekedda SC , Waxool FC ,2,1,1,-1,Win,1,1,0,0,0,0,1,1.7333333333333334,1.04,1.4285714285714286,1.8571428571428572,1.0,2.0,4.0,0.0,0.0,1
2016, Horseed S.C , Heegan S.C ,1,2,-1,1,Loss,3,3,1,3,3,1,3,1.5714285714285714,0.935064935064935,1.917808219178082,0.8767123287671232,,1.0,0.0,0.14285714285714285,0.42857142857142855,-1
2016, Sahafi FC , Mogadishu City Club ,0,6,-6,6,Loss,1,3,0,3,3,0,2,1.6774193548387097,1.4516129032258065,1.96,0.7333333333333333,,0.0,0.0,0.0,0.6,-6
2016, Badbaado FC , Jeenyo  FC ,0,7,-7,7,Loss,0,3,0,2,2,0,0,0.6521739130434783,2.9565217391304346,1.5846153846153845,1.4,,,0.0,0.0,1.0,-7
2016, Elman FC , Gaadiidka FC ,0,1,-1,1,Loss,1,2,1,0,0,1,1,1.8493150684931507,1.3287671232876712,1.588235294117647,1.5441176470588236,,0.0,0.0,0.5,0.0,-1
2016, Horseed S.C , Dekedda SC ,2,2,0,0,Draw,3,1,1,2,2,1,1,1.5714285714285714,0.935064935064935,1.662162162162162,0.8648648648648649,0.0,1.0,2.0,0.25,0.5,0
2016, Sahafi FC , Waxool FC ,1,1,0,0,Draw,1,1,0,1,1,0,0,1.6774193548387097,1.4516129032258065,1.4285714285714286,1.8571428571428572,0.0,0.0,3.0,0.0,1.0,0
2016, Badbaado FC , Heegan S.C ,1,8,-7,7,Loss,0,3,0,2,2,0,0,0.6521739130434783,2.9565217391304346,1.917808219178082,0.8767123287671232,,,0.0,0.0,1.0,-7
2016, Elman FC , Mogadishu City Club ,1,1,0,0,Draw,1,4,0,1,1,0,4,1.8493150684931507,1.3287671232876712,1.96,0.7333333333333333,0.0,0.0,0.0,0.0,0.2,0
2016, Gaadiidka FC , Jeenyo  FC ,1,2,-1,1,Loss,2,3,2,2,2,2,1,1.2272727272727273,1.3333333333333333,1.5846153846153845,1.4,,1.0,0.0,0.4,0.4,-1
2016, Dekedda SC , Sahafi FC ,4,1,3,-3,Win,1,1,1,0,0,1,2,1.7333333333333334,1.04,1.34375,1.34375,1.0,2.0,3.0,0.3333333333333333,0.0,3
2016, Badbaado FC , Horseed S.C ,2,3,-1,1,Loss,0,2,0,2,2,0,0,0.6521739130434783,2.9565217391304346,1.4583333333333333,1.1805555555555556,,,1.0,0.0,1.0,-1
2016, Elman FC , Waxool FC ,3,0,3,-3,Win,1,1,0,0,0,0,0,1.8493150684931507,1.3287671232876712,1.4285714285714286,1.8571428571428572,1.0,1.0,3.0,,,3
2016, Gaadiidka FC , Heegan S.C ,0,0,0,0,Draw,2,3,0,2,2,0,0,1.2272727272727273,1.3333333333333333,1.917808219178082,0.8767123287671232,0.0,1.0,0.0,0.0,1.0,0
2016, Jeenyo  FC , Mogadishu City Club ,2,3,-1,1,Loss,4,3,1,1,1,1,3,1.4366197183098592,1.5211267605633803,1.96,0.7333333333333333,,2.0,0.0,0.2,0.2,-1
2016, Badbaado FC , Dekedda SC ,0,2,-2,2,Loss,0,2,0,1,1,0,1,0.6521739130434783,2.9565217391304346,1.662162162162162,0.8648648648648649,,,2.0,0.0,0.5,-2
2016, Elman FC , Sahafi FC ,2,1,1,-1,Win,2,1,1,1,1,1,0,1.8493150684931507,1.3287671232876712,1.34375,1.34375,1.0,2.0,4.0,0.5,0.5,1
2016, Gaadiidka FC , Horseed S.C ,0,0,0,0,Draw,2,2,0,1,1,0,1,1.2272727272727273,1.3333333333333333,1.4583333333333333,1.1805555555555556,0.0,1.0,1.0,0.0,0.5,0
2016, Jeenyo  FC , Waxool FC ,4,1,3,-3,Win,3,0,0,0,0,0,0,1.4366197183098592,1.5211267605633803,1.4285714285714286,1.8571428571428572,1.0,2.0,4.0,,,3
2016, Mogadishu City Club , Heegan S.C ,1,1,0,0,Draw,3,3,1,1,1,1,3,1.7671232876712328,0.9041095890410958,1.917808219178082,0.8767123287671232,0.0,4.0,0.0,0.2,0.2,0
2016, Dekedda SC , Elman FC ,3,0,3,-3,Win,3,3,1,2,2,1,1,1.7333333333333334,1.04,1.75,1.144736842105263,1.0,3.0,3.0,0.25,0.5,3
2016, Gaadiidka FC , Badbaado FC ,2,0,2,-2,Win,1,0,0,0,0,0,0,1.2272727272727273,1.3333333333333333,0.8260869565217391,2.4347826086956523,1.0,2.0,4.0,,,2
2016, Jeenyo  FC , Sahafi FC ,1,0,1,-1,Win,4,0,1,0,0,1,3,1.4366197183098592,1.5211267605633803,1.34375,1.34375,1.0,3.0,4.0,0.25,0.0,1
2016, Mogadishu City Club , Horseed S.C ,2,0,2,-2,Win,3,1,2,0,0,2,3,1.7671232876712328,0.9041095890410958,1.4583333333333333,1.1805555555555556,1.0,4.0,1.0,0.4,0.0,2
2016, Heegan S.C , Waxool FC ,4,1,3,-3,Win,3,0,0,0,0,0,0,1.5789473684210527,0.8947368421052632,1.4285714285714286,1.8571428571428572,1.0,3.0,4.0,,,3
2016, Gaadiidka FC , Dekedda SC ,0,1,-1,1,Loss,2,4,0,1,1,0,3,1.2272727272727273,1.3333333333333333,1.662162162162162,0.8648648648648649,,1.0,2.0,0.0,0.25,-1
2016, Jeenyo  FC , Elman FC ,0,0,0,0,Draw,4,2,0,0,0,0,4,1.4366197183098592,1.5211267605633803,1.75,1.144736842105263,0.0,2.0,2.0,0.0,0.0,0
2016, Mogadishu City Club , Badbaado FC ,4,0,4,-4,Win,3,0,0,0,0,0,1,1.7671232876712328,0.9041095890410958,0.8260869565217391,2.4347826086956523,1.0,4.0,4.0,0.0,0.0,4
2016, Heegan S.C , Sahafi FC ,2,2,0,0,Draw,3,0,1,0,0,1,1,1.5789473684210527,0.8947368421052632,1.34375,1.34375,0.0,2.0,3.0,0.5,0.0,0
2016, Waxool FC , Horseed S.C ,2,1,1,-1,Win,0,1,0,1,1,0,0,1.1142857142857143,2.142857142857143,1.4583333333333333,1.1805555555555556,1.0,1.0,2.0,0.0,1.0,1
2016, Dekedda SC , Jeenyo  FC ,1,0,1,-1,Win,4,3,0,2,2,0,3,1.7333333333333334,1.04,1.5846153846153845,1.4,1.0,4.0,1.0,0.0,0.4,1
2016, Mogadishu City Club , Gaadiidka FC ,2,1,1,-1,Win,3,1,1,1,1,1,1,1.7671232876712328,0.9041095890410958,1.588235294117647,1.5441176470588236,1.0,4.0,1.0,0.3333333333333333,0.3333333333333333,1
2016, Heegan S.C , Elman FC ,0,0,0,0,Draw,2,2,0,1,1,0,3,1.5789473684210527,0.8947368421052632,1.75,1.144736842105263,0.0,2.0,2.0,0.0,0.25,0
2016, Waxool FC , Badbaado FC ,1,1,0,0,Draw,1,0,0,0,0,0,0,1.1142857142857143,2.142857142857143,0.8260869565217391,2.4347826086956523,0.0,1.0,3.0,,,0
2016, Horseed S.C , Sahafi FC ,2,1,1,-1,Win,1,0,1,0,0,1,3,1.5714285714285714,0.935064935064935,1.34375,1.34375,1.0,2.0,4.0,0.25,0.0,1
2016, Mogadishu City Club , Dekedda SC ,0,0,0,0,Draw,4,5,1,0,0,1,2,1.7671232876712328,0.9041095890410958,1.662162162162162,0.8648648648648649,0.0,3.0,1.0,0.3333333333333333,0.0,0
2016, Heegan S.C , Jeenyo  FC ,1,1,0,0,Draw,1,2,1,0,0,1,3,1.5789473684210527,0.8947368421052632,1.5846153846153845,1.4,0.0,2.0,1.0,0.25,0.0,0
2016, Waxool FC , Gaadiidka FC ,3,2,1,-1,Win,1,1,0,1,1,0,0,1.1142857142857143,2.142857142857143,1.588235294117647,1.5441176470588236,1.0,2.0,2.0,0.0,1.0,1
2016, Horseed S.C , Elman FC ,2,0,2,-2,Win,2,2,0,2,2,0,2,1.5714285714285714,0.935064935064935,1.75,1.144736842105263,1.0,2.0,2.0,0.0,0.5,2
2016, Sahafi FC , Badbaado FC ,12,1,11,-11,Win,0,0,2,0,0,2,0,1.6774193548387097,1.4516129032258065,0.8260869565217391,2.4347826086956523,1.0,1.0,3.0,1.0,0.0,11
2016, Heegan S.C , Elman FC ,0,2,-2,2,Loss,1,1,0,1,1,0,4,1.5789473684210527,0.8947368421052632,1.75,1.144736842105263,,1.0,2.0,0.0,0.2,-2
2016, Gaadiidka FC , Jeenyo  FC ,2,2,0,0,Draw,1,2,2,2,2,2,1,1.2272727272727273,1.3333333333333333,1.5846153846153845,1.4,0.0,1.0,1.0,0.4,0.4,0
2016, Jazeera SC , Mogadishu City Club ,1,3,-2,2,Loss,3,3,0,0,0,0,0,1.205128205128205,2.230769230769231,1.96,0.7333333333333333,,2.0,0.0,,,-2
2016, Bariga Dhexe , Dekedda SC ,1,3,-2,2,Loss,4,4,0,0,0,0,0,2.0,2.176470588235294,1.662162162162162,0.8648648648648649,,4.0,0.0,,,-2
2016, Horseed S.C , Waxool FC ,2,1,1,-1,Win,2,2,1,1,1,1,0,1.5714285714285714,0.935064935064935,1.4285714285714286,1.8571428571428572,1.0,3.0,4.0,0.5,0.5,1
2016, Jeenyo  FC , Heegan S.C ,1,1,0,0,Draw,1,1,0,1,1,0,4,1.4366197183098592,1.5211267605633803,1.917808219178082,0.8767123287671232,0.0,2.0,0.0,0.0,0.2,0
2016, Elman FC , Mogadishu City Club ,1,2,-1,1,Loss,1,4,0,1,1,0,5,1.8493150684931507,1.3287671232876712,1.96,0.7333333333333333,,2.0,0.0,0.0,0.16666666666666666,-1
2016, Gaadiidka FC , Dekedda SC ,1,1,0,0,Draw,1,4,0,1,1,0,3,1.2272727272727273,1.3333333333333333,1.662162162162162,0.8648648648648649,0.0,1.0,0.0,0.0,0.25,0
2016, Jazeera SC , Waxool FC ,1,4,-3,3,Loss,3,2,0,0,0,0,1,1.205128205128205,2.230769230769231,1.4285714285714286,1.8571428571428572,,1.0,4.0,0.0,0.0,-3
2016, Bariga Dhexe , Horseed S.C ,1,1,0,0,Draw,3,3,0,0,0,0,0,2.0,2.176470588235294,1.4583333333333333,1.1805555555555556,0.0,3.0,2.0,,,0
2017, Heegan S.C , Mogadishu City Club ,0,0,0,0,Draw,0,4,1,1,1,1,4,1.5789473684210527,0.8947368421052632,1.96,0.7333333333333333,0.0,0.0,0.0,0.16666666666666666,0.16666666666666666,0
2017, Jeenyo  FC , Dekedda SC ,2,2,0,0,Draw,0,3,2,1,1,2,3,1.4366197183098592,1.5211267605633803,1.662162162162162,0.8648648648648649,0.0,2.0,0.0,0.3333333333333333,0.16666666666666666,0
2017, Elman FC , Waxool FC ,5,2,3,-3,Win,1,3,1,0,0,1,0,1.8493150684931507,1.3287671232876712,1.4285714285714286,1.8571428571428572,1.0,3.0,4.0,1.0,0.0,3
2017, Gaadiidka FC , Horseed S.C ,1,1,0,0,Draw,0,3,0,1,1,0,2,1.2272727272727273,1.3333333333333333,1.4583333333333333,1.1805555555555556,0.0,1.0,2.0,0.0,0.3333333333333333,0
2017, Jazeera SC , Bariga Dhexe ,0,2,-2,2,Loss,2,2,0,1,1,0,0,1.205128205128205,2.230769230769231,1.1764705882352942,1.411764705882353,,0.0,2.0,0.0,1.0,-2
2017, Dekedda SC , Heegan S.C ,1,1,0,0,Draw,2,0,1,2,2,1,1,1.7333333333333334,1.04,1.917808219178082,0.8767123287671232,0.0,4.0,0.0,0.25,0.5,0
2017, Mogadishu City Club , Waxool FC ,3,0,3,-3,Win,3,2,1,0,0,1,0,1.7671232876712328,0.9041095890410958,1.4285714285714286,1.8571428571428572,1.0,4.0,4.0,1.0,0.0,3
2017, Jeenyo  FC , Horseed S.C ,1,0,1,-1,Win,0,3,2,0,0,2,2,1.4366197183098592,1.5211267605633803,1.4583333333333333,1.1805555555555556,1.0,2.0,3.0,0.5,0.0,1
2017, Gaadiidka FC , Jazeera SC ,7,0,7,-7,Win,0,1,0,0,0,0,0,1.2272727272727273,1.3333333333333333,1.605263157894737,2.0789473684210527,1.0,1.0,1.0,,,7
2017, Elman FC , Bariga Dhexe ,4,0,4,-4,Win,2,2,0,0,0,0,0,1.8493150684931507,1.3287671232876712,1.1764705882352942,1.411764705882353,1.0,4.0,3.0,,,4
2017, Heegan S.C , Waxool FC ,2,0,2,-2,Win,0,2,1,0,0,1,0,1.5789473684210527,0.8947368421052632,1.4285714285714286,1.8571428571428572,1.0,1.0,4.0,1.0,0.0,2
2017, Dekedda SC , Horseed S.C ,1,2,-1,1,Loss,1,2,2,1,1,2,2,1.7333333333333334,1.04,1.4583333333333333,1.1805555555555556,,3.0,2.0,0.4,0.2,-1
2017, Mogadishu City Club , Bariga Dhexe ,5,1,4,-4,Win,3,1,0,0,0,0,0,1.7671232876712328,0.9041095890410958,1.1764705882352942,1.411764705882353,1.0,4.0,4.0,,,4
2017, Jeenyo  FC , Jazeera SC ,2,2,0,0,Draw,1,0,0,0,0,0,0,1.4366197183098592,1.5211267605633803,1.605263157894737,2.0789473684210527,0.0,1.0,1.0,,,0
2017, Horseed S.C , Heegan S.C ,2,1,1,-1,Win,2,1,1,3,3,1,3,1.5714285714285714,0.935064935064935,1.917808219178082,0.8767123287671232,1.0,4.0,1.0,0.14285714285714285,0.42857142857142855,1
2017, Elman FC , Gaadiidka FC ,3,1,2,-2,Win,3,1,1,0,0,1,1,1.8493150684931507,1.3287671232876712,1.588235294117647,1.5441176470588236,1.0,4.0,3.0,0.5,0.0,2
2017, Dekedda SC , Jazeera SC ,6,0,6,-6,Win,1,0,0,0,0,0,0,1.7333333333333334,1.04,1.605263157894737,2.0789473684210527,1.0,3.0,2.0,,,6
2017, Waxool FC , Bariga Dhexe ,0,1,-1,1,Loss,1,1,1,0,0,1,1,1.1142857142857143,2.142857142857143,1.1764705882352942,1.411764705882353,,2.0,3.0,0.5,0.0,-1
2017, Mogadishu City Club , Gaadiidka FC ,2,1,1,-1,Win,4,1,2,1,1,2,1,1.7671232876712328,0.9041095890410958,1.588235294117647,1.5441176470588236,1.0,4.0,4.0,0.5,0.25,1
2017, Jeenyo  FC , Elman FC ,1,1,0,0,Draw,1,4,0,0,0,0,5,1.4366197183098592,1.5211267605633803,1.75,1.144736842105263,0.0,1.0,1.0,0.0,0.0,0
2017, Horseed S.C , Jazeera SC ,2,0,2,-2,Win,2,0,0,0,0,0,0,1.5714285714285714,0.935064935064935,1.605263157894737,2.0789473684210527,1.0,5.0,3.0,,,2
2017, Heegan S.C , Bariga Dhexe ,1,2,-1,1,Loss,1,2,0,0,0,0,0,1.5789473684210527,0.8947368421052632,1.1764705882352942,1.411764705882353,,1.0,2.0,,,-1
2017, Dekedda SC , Elman FC ,0,0,0,0,Draw,1,3,2,2,2,2,1,1.7333333333333334,1.04,1.75,1.144736842105263,0.0,2.0,1.0,0.4,0.4,0
2017, Waxool FC , Gaadiidka FC ,0,4,-4,4,Loss,1,1,1,1,1,1,0,1.1142857142857143,2.142857142857143,1.588235294117647,1.5441176470588236,,2.0,4.0,0.5,0.5,-4
2017, Mogadishu City Club , Jeenyo  FC ,2,2,0,0,Draw,4,1,1,1,1,1,3,1.7671232876712328,0.9041095890410958,1.5846153846153845,1.4,0.0,3.0,1.0,0.2,0.2,0
2017, Jazeera SC , Heegan S.C ,1,2,-1,1,Loss,0,1,0,0,0,0,0,1.205128205128205,2.230769230769231,1.917808219178082,0.8767123287671232,,,1.0,,,-1
2017, Bariga Dhexe , Gaadiidka FC ,0,6,-6,6,Loss,3,2,0,0,0,0,0,2.0,2.176470588235294,1.588235294117647,1.5441176470588236,,2.0,3.0,,,-6
2017, Horseed S.C , Elman FC ,1,1,0,0,Draw,3,3,1,2,2,1,2,1.5714285714285714,0.935064935064935,1.75,1.144736842105263,0.0,4.0,1.0,0.2,0.4,0
2017, Waxool FC , Jeenyo  FC ,0,5,-5,5,Loss,0,1,0,1,1,0,0,1.1142857142857143,2.142857142857143,1.5846153846153845,1.4,,1.0,1.0,0.0,1.0,-5
2017, Dekedda SC , Mogadishu City Club ,1,0,1,-1,Win,1,3,0,1,1,0,3,1.7333333333333334,1.04,1.96,0.7333333333333333,1.0,2.0,1.0,0.0,0.25,1
2017, Jazeera SC , Elman FC ,0,7,-7,7,Loss,0,2,0,0,0,0,0,1.205128205128205,2.230769230769231,1.75,1.144736842105263,,,0.0,,,-7
2017, Heegan S.C , Gaadiidka FC ,1,0,1,-1,Win,2,3,2,0,0,2,1,1.5789473684210527,0.8947368421052632,1.588235294117647,1.5441176470588236,1.0,2.0,3.0,0.6666666666666666,0.0,1
2017, Bariga Dhexe , Jeenyo  FC ,1,5,-4,4,Loss,2,2,0,0,0,0,0,2.0,2.176470588235294,1.5846153846153845,1.4,,1.0,0.0,,,-4
2017, Horseed S.C , Mogadishu City Club ,0,3,-3,3,Loss,3,3,0,3,3,0,3,1.5714285714285714,0.935064935064935,1.96,0.7333333333333333,,3.0,1.0,0.0,0.5,-3
2017, Waxool FC , Dekedda SC ,1,7,-6,6,Loss,0,2,0,1,1,0,1,1.1142857142857143,2.142857142857143,1.662162162162162,0.8648648648648649,,1.0,0.0,0.0,0.5,-6
2017, Elman FC , Heegan S.C ,0,0,0,0,Draw,2,3,1,0,0,1,4,1.8493150684931507,1.3287671232876712,1.917808219178082,0.8767123287671232,0.0,3.0,1.0,0.2,0.0,0
2017, Jeenyo  FC , Gaadiidka FC ,1,1,0,0,Draw,2,2,2,2,2,2,2,1.4366197183098592,1.5211267605633803,1.588235294117647,1.5441176470588236,0.0,1.0,2.0,0.3333333333333333,0.3333333333333333,0
2017, Mogadishu City Club , Jazeera SC ,3,1,2,-2,Win,3,0,0,0,0,0,0,1.7671232876712328,0.9041095890410958,1.605263157894737,2.0789473684210527,1.0,4.0,4.0,,,2
2017, Dekedda SC , Bariga Dhexe ,3,0,3,-3,Win,3,2,0,0,0,0,0,1.7333333333333334,1.04,1.1764705882352942,1.411764705882353,1.0,3.0,3.0,,,3
2017, Waxool FC , Horseed S.C ,0,0,0,0,Draw,0,3,1,2,2,1,0,1.1142857142857143,2.142857142857143,1.4583333333333333,1.1805555555555556,0.0,0.0,1.0,0.3333333333333333,0.6666666666666666,0
2017, Dekedda SC , Gaadiidka FC ,2,1,1,-1,Win,4,2,1,0,0,1,4,1.7333333333333334,1.04,1.588235294117647,1.5441176470588236,1.0,4.0,2.0,0.2,0.0,1
2017, Heegan S.C , Jeenyo  FC ,4,3,1,-1,Win,2,2,1,0,0,1,5,1.5789473684210527,0.8947368421052632,1.5846153846153845,1.4,1.0,3.0,1.0,0.16666666666666666,0.0,1
2017, Mogadishu City Club , Elman FC ,0,1,-1,1,Loss,3,1,1,0,0,1,5,1.7671232876712328,0.9041095890410958,1.75,1.144736842105263,,3.0,0.0,0.16666666666666666,0.0,-1
2017, Horseed S.C , Bariga Dhexe ,0,0,0,0,Draw,2,2,0,0,0,0,1,1.5714285714285714,0.935064935064935,1.1764705882352942,1.411764705882353,0.0,2.0,2.0,0.0,0.0,0
2017, Waxool FC , Jazeera SC ,1,2,-1,1,Loss,0,0,0,0,0,0,1,1.1142857142857143,2.142857142857143,1.605263157894737,2.0789473684210527,,0.0,3.0,0.0,0.0,-1
2017, Mogadishu City Club , Heegan S.C ,0,1,-1,1,Loss,2,3,1,1,1,1,5,1.7671232876712328,0.9041095890410958,1.917808219178082,0.8767123287671232,,2.0,1.0,0.14285714285714285,0.14285714285714285,-1
2017, Dekedda SC , Jeenyo  FC ,4,0,4,-4,Win,4,2,1,2,2,1,4,1.7333333333333334,1.04,1.5846153846153845,1.4,1.0,4.0,2.0,0.14285714285714285,0.2857142857142857,4
2017, Waxool FC , Elman FC ,0,2,-2,2,Loss,0,2,0,2,2,0,0,1.1142857142857143,2.142857142857143,1.75,1.144736842105263,,0.0,0.0,0.0,1.0,-2
2017, Horseed S.C , Gaadiidka FC ,2,1,1,-1,Win,1,2,1,0,0,1,3,1.5714285714285714,0.935064935064935,1.588235294117647,1.5441176470588236,1.0,2.0,3.0,0.25,0.0,1
2017, Bariga Dhexe , Jazeera SC ,0,1,-1,1,Loss,1,1,1,0,0,1,0,2.0,2.176470588235294,1.605263157894737,2.0789473684210527,,0.0,3.0,1.0,0.0,-1
2017, Heegan S.C , Dekedda SC ,0,2,-2,2,Loss,4,5,2,1,1,2,2,1.5789473684210527,0.8947368421052632,1.662162162162162,0.8648648648648649,,3.0,0.0,0.4,0.2,-2
2017, Waxool FC , Mogadishu City Club ,2,1,1,-1,Win,0,2,0,2,2,0,0,1.1142857142857143,2.142857142857143,1.96,0.7333333333333333,1.0,1.0,2.0,0.0,1.0,1
2017, Horseed S.C , Jeenyo  FC ,1,0,1,-1,Win,1,2,0,3,3,0,2,1.5714285714285714,0.935064935064935,1.5846153846153845,1.4,1.0,2.0,3.0,0.0,0.6,1
2017, Bariga Dhexe , Elman FC ,0,6,-6,6,Loss,0,3,0,1,1,0,0,2.0,2.176470588235294,1.75,1.144736842105263,,0.0,0.0,0.0,1.0,-6
2017, Jazeera SC , Gaadiidka FC ,1,6,-5,5,Loss,2,1,0,1,1,0,0,1.205128205128205,2.230769230769231,1.588235294117647,1.5441176470588236,,,3.0,0.0,1.0,-5
2017, Waxool FC , Heegan S.C ,0,2,-2,2,Loss,1,3,0,2,2,0,0,1.1142857142857143,2.142857142857143,1.917808219178082,0.8767123287671232,,1.0,1.0,0.0,1.0,-2
2017, Horseed S.C , Dekedda SC ,1,1,0,0,Draw,2,5,1,2,2,1,2,1.5714285714285714,0.935064935064935,1.662162162162162,0.8648648648648649,0.0,2.0,0.0,0.2,0.4,0
2017, Bariga Dhexe , Mogadishu City Club ,1,4,-3,3,Loss,0,2,0,1,1,0,0,2.0,2.176470588235294,1.96,0.7333333333333333,,,2.0,0.0,1.0,-3
2017, Jazeera SC , Jeenyo  FC ,1,3,-2,2,Loss,2,1,0,0,0,0,1,1.205128205128205,2.230769230769231,1.5846153846153845,1.4,,,3.0,0.0,0.0,-2
2017, Gaadiidka FC , Elman FC ,3,0,3,-3,Win,1,4,0,2,2,0,1,1.2272727272727273,1.3333333333333333,1.75,1.144736842105263,1.0,2.0,1.0,0.0,0.6666666666666666,3
2017, Heegan S.C , Horseed S.C ,1,1,0,0,Draw,3,2,3,2,2,3,3,1.5789473684210527,0.8947368421052632,1.4583333333333333,1.1805555555555556,0.0,2.0,1.0,0.375,0.25,0
2017, Bariga Dhexe , Waxool FC ,0,2,-2,2,Loss,0,1,0,1,1,0,1,2.0,2.176470588235294,1.4285714285714286,1.8571428571428572,,,3.0,0.0,0.5,-2
2017, Jazeera SC , Dekedda SC ,0,1,-1,1,Loss,2,4,0,1,1,0,0,1.205128205128205,2.230769230769231,1.662162162162162,0.8648648648648649,,,0.0,0.0,1.0,-1
2017, Gaadiidka FC , Mogadishu City Club ,0,0,0,0,Draw,2,2,1,3,3,1,1,1.2272727272727273,1.3333333333333333,1.96,0.7333333333333333,0.0,2.0,2.0,0.2,0.6,0
2017, Elman FC , Jeenyo  FC ,0,1,-1,1,Loss,3,1,0,0,0,0,6,1.8493150684931507,1.3287671232876712,1.5846153846153845,1.4,,3.0,3.0,0.0,0.0,-1
2017, Bariga Dhexe , Heegan S.C ,0,4,-4,4,Loss,0,3,0,0,0,0,0,2.0,2.176470588235294,1.917808219178082,0.8767123287671232,,,0.0,,,-4
2017, Jazeera SC , Horseed S.C ,1,3,-2,2,Loss,2,2,0,1,1,0,0,1.205128205128205,2.230769230769231,1.4583333333333333,1.1805555555555556,,,1.0,0.0,1.0,-2
2017, Gaadiidka FC , Waxool FC ,1,1,0,0,Draw,2,2,1,1,1,1,0,1.2272727272727273,1.3333333333333333,1.4285714285714286,1.8571428571428572,0.0,2.0,3.0,0.5,0.5,0
2017, Elman FC , Dekedda SC ,0,2,-2,2,Loss,3,4,2,2,2,2,2,1.8493150684931507,1.3287671232876712,1.662162162162162,0.8648648648648649,,2.0,0.0,0.3333333333333333,0.3333333333333333,-2
2017, Jeenyo  FC , Mogadishu City Club ,0,3,-3,3,Loss,2,1,1,1,1,1,4,1.4366197183098592,1.5211267605633803,1.96,0.7333333333333333,,1.0,1.0,0.16666666666666666,0.16666666666666666,-3
2017, Heegan S.C , Jazeera SC ,2,0,2,-2,Win,3,1,0,0,0,0,0,1.5789473684210527,0.8947368421052632,1.605263157894737,2.0789473684210527,1.0,3.0,3.0,,,2
2017, Gaadiidka FC , Bariga Dhexe ,2,0,2,-2,Win,2,0,0,0,0,0,0,1.2272727272727273,1.3333333333333333,1.1764705882352942,1.411764705882353,1.0,3.0,2.0,,,2
2017, Elman FC , Horseed S.C ,1,1,0,0,Draw,2,3,2,1,1,2,3,1.8493150684931507,1.3287671232876712,1.4583333333333333,1.1805555555555556,0.0,1.0,0.0,0.3333333333333333,0.16666666666666666,0
2017, Jeenyo  FC , Waxool FC ,0,0,0,0,Draw,2,2,1,0,0,1,0,1.4366197183098592,1.5211267605633803,1.4285714285714286,1.8571428571428572,0.0,0.0,2.0,1.0,0.0,0
2017, Mogadishu City Club , Dekedda SC ,1,1,0,0,Draw,2,4,1,1,1,1,3,1.7671232876712328,0.9041095890410958,1.662162162162162,0.8648648648648649,0.0,1.0,0.0,0.2,0.2,0
2017, Gaadiidka FC , Heegan S.C ,2,3,-1,1,Loss,3,3,0,3,3,0,1,1.2272727272727273,1.3333333333333333,1.917808219178082,0.8767123287671232,,2.0,0.0,0.0,0.75,-1
2017, Elman FC , Jazeera SC ,4,0,4,-4,Win,1,0,0,0,0,0,0,1.8493150684931507,1.3287671232876712,1.605263157894737,2.0789473684210527,1.0,1.0,3.0,,,4
2017, Jeenyo  FC , Bariga Dhexe ,1,0,1,-1,Win,2,0,0,0,0,0,0,1.4366197183098592,1.5211267605633803,1.1764705882352942,1.411764705882353,1.0,1.0,3.0,,,1
2017, Mogadishu City Club , Horseed S.C ,1,0,1,-1,Win,2,2,3,0,0,3,3,1.7671232876712328,0.9041095890410958,1.4583333333333333,1.1805555555555556,1.0,2.0,1.0,0.5,0.0,1
2017, Dekedda SC , Waxool FC ,2,0,2,-2,Win,3,2,1,0,0,1,1,1.7333333333333334,1.04,1.4285714285714286,1.8571428571428572,1.0,5.0,2.0,0.5,0.0,2
2018, Dekedda SC , Waxool FC ,1,0,1,-1,Win,3,1,2,0,0,2,1,1.7333333333333334,1.04,1.4285714285714286,1.8571428571428572,1.0,5.0,2.0,0.6666666666666666,0.0,1
2018, Batroolka FC , Gaadiidka FC ,0,0,0,0,Draw,1,2,0,2,2,0,1,0.8333333333333334,3.0,1.588235294117647,1.5441176470588236,0.0,0.0,2.0,0.0,0.6666666666666666,0
2018, Heegan S.C , Elman FC ,4,1,3,-3,Win,4,1,0,1,1,0,5,1.5789473684210527,0.8947368421052632,1.75,1.144736842105263,1.0,3.0,2.0,0.0,0.16666666666666666,3
2018, Madbacadda FC , Jeenyo  FC ,1,1,0,0,Draw,1,3,0,0,0,0,0,0.8,1.72,1.5846153846153845,1.4,0.0,0.0,2.0,,,0
2018, Horseed S.C , Mogadishu City Club ,1,0,1,-1,Win,1,3,0,4,4,0,3,1.5714285714285714,0.935064935064935,1.96,0.7333333333333333,1.0,3.0,2.0,0.0,0.5714285714285714,1
2018, Gaadiidka FC , Dekedda SC ,1,1,0,0,Draw,1,4,0,2,2,0,4,1.2272727272727273,1.3333333333333333,1.662162162162162,0.8648648648648649,0.0,1.0,0.0,0.0,0.3333333333333333,0
2018, Waxool FC , Elman FC ,0,4,-4,4,Loss,1,1,0,2,2,0,0,1.1142857142857143,2.142857142857143,1.75,1.144736842105263,,1.0,2.0,0.0,1.0,-4
2018, Batroolka FC , Jeenyo  FC ,0,0,0,0,Draw,1,2,0,2,2,0,1,0.8333333333333334,3.0,1.5846153846153845,1.4,0.0,0.0,1.0,0.0,0.6666666666666666,0
2018, Heegan S.C , Mogadishu City Club ,1,1,0,0,Draw,4,2,1,1,1,1,5,1.5789473684210527,0.8947368421052632,1.96,0.7333333333333333,0.0,2.0,1.0,0.14285714285714285,0.14285714285714285,0
2018, Madbacadda FC , Horseed S.C ,0,0,0,0,Draw,1,2,0,0,0,0,0,0.8,1.72,1.4583333333333333,1.1805555555555556,0.0,0.0,1.0,,,0
2018, Dekedda SC , Elman FC ,1,0,1,-1,Win,3,2,2,2,2,2,2,1.7333333333333334,1.04,1.75,1.144736842105263,1.0,5.0,3.0,0.3333333333333333,0.3333333333333333,1
2018, Gaadiidka FC , Jeenyo  FC ,0,1,-1,1,Loss,1,1,2,2,2,2,3,1.2272727272727273,1.3333333333333333,1.5846153846153845,1.4,,1.0,0.0,0.2857142857142857,0.2857142857142857,-1
2018, Waxool FC , Mogadishu City Club ,1,4,-3,3,Loss,0,2,1,2,2,1,0,1.1142857142857143,2.142857142857143,1.96,0.7333333333333333,,1.0,1.0,0.3333333333333333,0.6666666666666666,-3
2018, Batroolka FC , Horseed S.C ,1,5,-4,4,Loss,1,2,0,2,2,0,1,0.8333333333333334,3.0,1.4583333333333333,1.1805555555555556,,0.0,1.0,0.0,0.6666666666666666,-4
2018, Heegan S.C , Madbacadda FC ,0,0,0,0,Draw,4,1,0,0,0,0,0,1.5789473684210527,0.8947368421052632,0.9166666666666666,1.5833333333333333,0.0,2.0,2.0,,,0
2018, Jeenyo  FC , Dekedda SC ,0,2,-2,2,Loss,2,3,2,2,2,2,4,1.4366197183098592,1.5211267605633803,1.662162162162162,0.8648648648648649,,1.0,0.0,0.25,0.25,-2
2018, Elman FC , Mogadishu City Club ,2,6,-4,4,Loss,2,2,0,1,1,0,5,1.8493150684931507,1.3287671232876712,1.96,0.7333333333333333,,1.0,1.0,0.0,0.16666666666666666,-4
2018, Gaadiidka FC , Horseed S.C ,1,3,-2,2,Loss,1,2,0,2,2,0,3,1.2272727272727273,1.3333333333333333,1.4583333333333333,1.1805555555555556,,1.0,1.0,0.0,0.4,-2
2018, Waxool FC , Madbacadda FC ,0,1,-1,1,Loss,0,1,0,0,0,0,0,1.1142857142857143,2.142857142857143,0.9166666666666666,1.5833333333333333,,1.0,1.0,,,-1
2018, Batroolka FC , Heegan S.C ,1,2,-1,1,Loss,0,3,0,2,2,0,0,0.8333333333333334,3.0,1.917808219178082,0.8767123287671232,,0.0,,0.0,1.0,-1
2018, Dekedda SC , Mogadishu City Club ,1,0,1,-1,Win,4,3,1,1,1,1,4,1.7333333333333334,1.04,1.96,0.7333333333333333,1.0,5.0,2.0,0.16666666666666666,0.16666666666666666,1
2018, Jeenyo  FC , Horseed S.C ,0,2,-2,2,Loss,2,3,3,1,1,3,2,1.4366197183098592,1.5211267605633803,1.4583333333333333,1.1805555555555556,,1.0,1.0,0.5,0.16666666666666666,-2
2018, Elman FC , Madbacadda FC ,5,1,4,-4,Win,2,2,0,0,0,0,0,1.8493150684931507,1.3287671232876712,0.9166666666666666,1.5833333333333333,1.0,2.0,2.0,,,4
2018, Gaadiidka FC , Heegan S.C ,1,2,-1,1,Loss,0,3,0,3,3,0,1,1.2272727272727273,1.3333333333333333,1.917808219178082,0.8767123287671232,,0.0,,0.0,0.75,-1
2018, Waxool FC , Batroolka FC ,2,2,0,0,Draw,0,0,0,0,0,0,0,1.1142857142857143,2.142857142857143,0.8846153846153846,3.230769230769231,0.0,0.0,3.0,,,0
2018, Horseed S.C , Dekedda SC ,0,0,0,0,Draw,4,4,1,2,2,1,3,1.5714285714285714,0.935064935064935,1.662162162162162,0.8648648648648649,0.0,3.0,0.0,0.16666666666666666,0.3333333333333333,0
2018, Mogadishu City Club , Madbacadda FC ,2,0,2,-2,Win,2,1,0,0,0,0,0,1.7671232876712328,0.9041095890410958,0.9166666666666666,1.5833333333333333,1.0,2.0,2.0,,,2
2018, Jeenyo  FC , Heegan S.C ,1,0,1,-1,Win,1,3,0,2,2,0,5,1.4366197183098592,1.5211267605633803,1.917808219178082,0.8767123287671232,1.0,2.0,1.0,0.0,0.2857142857142857,1
2018, Elman FC , Batroolka FC ,1,4,-3,3,Loss,2,0,2,0,0,2,0,1.8493150684931507,1.3287671232876712,0.8846153846153846,3.230769230769231,,2.0,2.0,1.0,0.0,-3
2018, Gaadiidka FC , Waxool FC ,1,1,0,0,Draw,0,0,1,1,1,1,1,1.2272727272727273,1.3333333333333333,1.4285714285714286,1.8571428571428572,0.0,0.0,2.0,0.3333333333333333,0.3333333333333333,0
2018, Dekedda SC , Madbacadda FC ,7,1,6,-6,Win,3,1,0,0,0,0,0,1.7333333333333334,1.04,0.9166666666666666,1.5833333333333333,1.0,5.0,3.0,,,6
2018, Horseed S.C , Heegan S.C ,0,0,0,0,Draw,3,2,2,3,3,2,4,1.5714285714285714,0.935064935064935,1.917808219178082,0.8767123287671232,0.0,2.0,1.0,0.2222222222222222,0.3333333333333333,0
2018, Mogadishu City Club , Batroolka FC ,1,1,0,0,Draw,3,1,2,0,0,2,0,1.7671232876712328,0.9041095890410958,0.8846153846153846,3.230769230769231,0.0,2.0,2.0,1.0,0.0,0
2018, Jeenyo  FC , Waxool FC ,0,1,-1,1,Loss,2,0,1,0,0,1,1,1.4366197183098592,1.5211267605633803,1.4285714285714286,1.8571428571428572,,2.0,2.0,0.5,0.0,-1
2018, Elman FC , Gaadiidka FC ,3,0,3,-3,Win,2,0,2,1,1,2,1,1.8493150684931507,1.3287671232876712,1.588235294117647,1.5441176470588236,1.0,3.0,3.0,0.5,0.25,3
2018, Heegan S.C , Dekedda SC ,0,0,0,0,Draw,2,4,2,1,1,2,2,1.5789473684210527,0.8947368421052632,1.662162162162162,0.8648648648648649,0.0,2.0,0.0,0.4,0.2,0
2018, Madbacadda FC , Batroolka FC ,0,0,0,0,Draw,1,1,0,0,0,0,0,0.8,1.72,0.8846153846153846,3.230769230769231,0.0,0.0,1.0,,,0
2018, Horseed S.C , Waxool FC ,3,0,3,-3,Win,3,1,2,1,1,2,1,1.5714285714285714,0.935064935064935,1.4285714285714286,1.8571428571428572,1.0,2.0,3.0,0.5,0.25,3
2018, Mogadishu City Club , Gaadiidka FC ,3,0,3,-3,Win,3,0,3,1,1,3,2,1.7671232876712328,0.9041095890410958,1.588235294117647,1.5441176470588236,1.0,3.0,3.0,0.5,0.16666666666666666,3
2018, Jeenyo  FC , Elman FC ,2,2,0,0,Draw,2,3,0,0,0,0,6,1.4366197183098592,1.5211267605633803,1.75,1.144736842105263,0.0,1.0,3.0,0.0,0.0,0
2018, Dekedda SC , Batroolka FC ,5,0,5,-5,Win,3,1,1,0,0,1,0,1.7333333333333334,1.04,0.8846153846153846,3.230769230769231,1.0,5.0,1.0,1.0,0.0,5
2018, Heegan S.C , Waxool FC ,5,0,5,-5,Win,2,1,2,0,0,2,0,1.5789473684210527,0.8947368421052632,1.4285714285714286,1.8571428571428572,1.0,2.0,3.0,1.0,0.0,5
2018, Madbacadda FC , Gaadiidka FC ,0,2,-2,2,Loss,1,0,0,0,0,0,0,0.8,1.72,1.588235294117647,1.5441176470588236,,0.0,2.0,,,-2
2018, Horseed S.C , Elman FC ,2,0,2,-2,Win,3,3,1,2,2,1,4,1.5714285714285714,0.935064935064935,1.75,1.144736842105263,1.0,3.0,3.0,0.14285714285714285,0.2857142857142857,2
2018, Mogadishu City Club , Jeenyo  FC ,4,2,2,-2,Win,3,1,1,1,1,1,4,1.7671232876712328,0.9041095890410958,1.5846153846153845,1.4,1.0,4.0,1.0,0.16666666666666666,0.16666666666666666,2
2018, Waxool FC , Dekedda SC ,1,4,-3,3,Loss,1,3,0,3,3,0,1,1.1142857142857143,2.142857142857143,1.662162162162162,0.8648648648648649,,0.0,0.0,0.0,0.75,-3
2018, Gaadiidka FC , Batroolka FC ,0,1,-1,1,Loss,1,1,2,0,0,2,2,1.2272727272727273,1.3333333333333333,0.8846153846153846,3.230769230769231,,0.0,1.0,0.5,0.0,-1
2018, Elman FC , Heegan S.C ,1,2,-1,1,Loss,2,2,1,1,1,1,5,1.8493150684931507,1.3287671232876712,1.917808219178082,0.8767123287671232,,2.0,1.0,0.14285714285714285,0.14285714285714285,-1
2018, Jeenyo  FC , Madbacadda FC ,1,1,0,0,Draw,1,0,0,0,0,0,1,1.4366197183098592,1.5211267605633803,0.9166666666666666,1.5833333333333333,0.0,1.0,3.0,0.0,0.0,0
2018, Mogadishu City Club , Horseed S.C ,3,2,1,-1,Win,3,3,4,1,1,4,3,1.7671232876712328,0.9041095890410958,1.4583333333333333,1.1805555555555556,1.0,4.0,1.0,0.5,0.125,1
2018, Dekedda SC , Gaadiidka FC ,6,0,6,-6,Win,3,1,2,0,0,2,5,1.7333333333333334,1.04,1.588235294117647,1.5441176470588236,1.0,5.0,3.0,0.2857142857142857,0.0,6
2018, Elman FC , Waxool FC ,4,1,3,-3,Win,2,1,2,0,0,2,0,1.8493150684931507,1.3287671232876712,1.4285714285714286,1.8571428571428572,1.0,3.0,3.0,1.0,0.0,3
2018, Jeenyo  FC , Batroolka FC ,6,0,6,-6,Win,1,2,2,0,0,2,2,1.4366197183098592,1.5211267605633803,0.8846153846153846,3.230769230769231,1.0,2.0,2.0,0.5,0.0,6
2018, Mogadishu City Club , Heegan S.C ,1,1,0,0,Draw,4,2,1,1,1,1,6,1.7671232876712328,0.9041095890410958,1.917808219178082,0.8767123287671232,0.0,3.0,1.0,0.125,0.125,0
2018, Horseed S.C , Madbacadda FC ,1,1,0,0,Draw,2,0,0,0,0,0,1,1.5714285714285714,0.935064935064935,0.9166666666666666,1.5833333333333333,0.0,2.0,3.0,0.0,0.0,0
2018, Elman FC , Dekedda SC ,3,0,3,-3,Win,2,4,2,3,3,2,2,1.8493150684931507,1.3287671232876712,1.662162162162162,0.8648648648648649,1.0,3.0,1.0,0.2857142857142857,0.42857142857142855,3
2018, Jeenyo  FC , Gaadiidka FC ,3,6,-3,3,Loss,1,1,2,2,2,2,3,1.4366197183098592,1.5211267605633803,1.588235294117647,1.5441176470588236,,1.0,3.0,0.2857142857142857,0.2857142857142857,-3
2018, Mogadishu City Club , Waxool FC ,2,0,2,-2,Win,3,1,2,1,1,2,0,1.7671232876712328,0.9041095890410958,1.4285714285714286,1.8571428571428572,1.0,4.0,4.0,0.6666666666666666,0.3333333333333333,2
2018, Horseed S.C , Batroolka FC ,5,0,5,-5,Win,2,1,2,0,0,2,1,1.5714285714285714,0.935064935064935,0.8846153846153846,3.230769230769231,1.0,3.0,3.0,0.6666666666666666,0.0,5
2018, Madbacadda FC , Heegan S.C ,1,0,1,-1,Win,0,2,0,0,0,0,1,0.8,1.72,1.917808219178082,0.8767123287671232,1.0,1.0,2.0,0.0,0.0,1
2018, Dekedda SC , Jeenyo  FC ,3,0,3,-3,Win,3,1,2,2,2,2,4,1.7333333333333334,1.04,1.5846153846153845,1.4,1.0,5.0,2.0,0.25,0.25,3
2018, Mogadishu City Club , Elman FC ,4,2,2,-2,Win,4,2,1,0,0,1,5,1.7671232876712328,0.9041095890410958,1.75,1.144736842105263,1.0,4.0,3.0,0.16666666666666666,0.0,2
2018, Horseed S.C , Gaadiidka FC ,0,0,0,0,Draw,3,2,2,0,0,2,3,1.5714285714285714,0.935064935064935,1.588235294117647,1.5441176470588236,0.0,3.0,2.0,0.4,0.0,0
2018, Madbacadda FC , Waxool FC ,1,2,-1,1,Loss,1,0,0,0,0,0,0,0.8,1.72,1.4285714285714286,1.8571428571428572,,1.0,4.0,,,-1
2018, Heegan S.C , Batroolka FC ,3,0,3,-3,Win,2,1,2,0,0,2,0,1.5789473684210527,0.8947368421052632,0.8846153846153846,3.230769230769231,1.0,2.0,4.0,1.0,0.0,3
2018, Mogadishu City Club , Dekedda SC ,0,0,0,0,Draw,4,4,1,2,2,1,4,1.7671232876712328,0.9041095890410958,1.662162162162162,0.8648648648648649,0.0,3.0,1.0,0.14285714285714285,0.2857142857142857,0
2018, Horseed S.C , Jeenyo  FC ,0,0,0,0,Draw,2,1,1,3,3,1,2,1.5714285714285714,0.935064935064935,1.5846153846153845,1.4,0.0,2.0,2.0,0.16666666666666666,0.5,0
2018, Madbacadda FC , Elman FC ,1,1,0,0,Draw,1,2,0,1,1,0,0,0.8,1.72,1.75,1.144736842105263,0.0,1.0,3.0,0.0,1.0,0
2018, Heegan S.C , Gaadiidka FC ,3,1,2,-2,Win,3,2,3,0,0,3,1,1.5789473684210527,0.8947368421052632,1.588235294117647,1.5441176470588236,1.0,3.0,2.0,0.75,0.0,2
2018, Batroolka FC , Waxool FC ,1,2,-1,1,Loss,1,1,0,0,0,0,1,0.8333333333333334,3.0,1.4285714285714286,1.8571428571428572,,0.0,3.0,0.0,0.0,-1
2018, Dekedda SC , Horseed S.C ,2,2,0,0,Draw,3,1,2,1,1,2,4,1.7333333333333334,1.04,1.4583333333333333,1.1805555555555556,0.0,4.0,1.0,0.2857142857142857,0.14285714285714285,0
2018, Madbacadda FC , Mogadishu City Club ,2,2,0,0,Draw,1,3,0,1,1,0,0,0.8,1.72,1.96,0.7333333333333333,0.0,1.0,1.0,0.0,1.0,0
2018, Heegan S.C , Jeenyo  FC ,4,1,3,-3,Win,3,1,2,1,1,2,5,1.5789473684210527,0.8947368421052632,1.5846153846153845,1.4,1.0,4.0,3.0,0.25,0.125,3
2018, Batroolka FC , Mogadishu City Club ,1,2,-1,1,Loss,1,2,0,2,2,0,1,0.8333333333333334,3.0,1.96,0.7333333333333333,,0.0,1.0,0.0,0.6666666666666666,-1
2018, Waxool FC , Jeenyo  FC ,1,2,-1,1,Loss,2,1,0,1,1,0,1,1.1142857142857143,2.142857142857143,1.5846153846153845,1.4,,0.0,3.0,0.0,0.5,-1
2018, Gaadiidka FC , Mogadishu City Club ,1,2,-1,1,Loss,1,3,1,4,4,1,2,1.2272727272727273,1.3333333333333333,1.96,0.7333333333333333,,0.0,1.0,0.14285714285714285,0.5714285714285714,-1
2018, Batroolka FC , Elman FC ,2,2,0,0,Draw,0,2,0,2,2,0,0,0.8333333333333334,3.0,1.75,1.144736842105263,0.0,0.0,2.0,0.0,1.0,0
2018, Jeenyo  FC , Mogadishu City Club ,1,2,-1,1,Loss,1,3,1,2,2,1,4,1.4366197183098592,1.5211267605633803,1.96,0.7333333333333333,,1.0,1.0,0.14285714285714285,0.2857142857142857,-1
2018, Heegan S.C , Horseed S.C ,1,0,1,-1,Win,3,1,3,2,2,3,5,1.5789473684210527,0.8947368421052632,1.4583333333333333,1.1805555555555556,1.0,5.0,2.0,0.3,0.2,1
2018, Gaadiidka FC , Elman FC ,2,2,0,0,Draw,1,2,1,4,4,1,1,1.2272727272727273,1.3333333333333333,1.75,1.144736842105263,0.0,0.0,2.0,0.16666666666666666,0.6666666666666666,0
2018, Batroolka FC , Madbacadda FC ,1,4,-3,3,Loss,0,1,0,0,0,0,1,0.8333333333333334,3.0,0.9166666666666666,1.5833333333333333,,0.0,2.0,0.0,0.0,-3
2018, Dekedda SC , Heegan S.C ,1,1,0,0,Draw,2,4,1,2,2,1,3,1.7333333333333334,1.04,1.917808219178082,0.8767123287671232,0.0,3.0,1.0,0.16666666666666666,0.3333333333333333,0
2018, Waxool FC , Gaadiidka FC ,1,3,-2,2,Loss,2,1,1,1,1,1,2,1.1142857142857143,2.142857142857143,1.588235294117647,1.5441176470588236,,0.0,2.0,0.25,0.25,-2
2018, Elman FC , Jeenyo  FC ,2,1,1,-1,Win,1,1,0,0,0,0,7,1.8493150684931507,1.3287671232876712,1.5846153846153845,1.4,1.0,4.0,3.0,0.0,0.0,1
2018, Madbacadda FC , Dekedda SC ,0,5,-5,5,Loss,2,1,0,1,1,0,0,0.8,1.72,1.662162162162162,0.8648648648648649,,1.0,1.0,0.0,1.0,-5
2018, Waxool FC , Horseed S.C ,1,4,-3,3,Loss,2,1,1,3,3,1,1,1.1142857142857143,2.142857142857143,1.4583333333333333,1.1805555555555556,,0.0,2.0,0.2,0.6,-3
2018, Gaadiidka FC , Madbacadda FC ,4,1,3,-3,Win,1,1,0,0,0,0,0,1.2272727272727273,1.3333333333333333,0.9166666666666666,1.5833333333333333,1.0,1.0,2.0,,,3
2018, Batroolka FC , Dekedda SC ,1,6,-5,5,Loss,0,2,0,2,2,0,0,0.8333333333333334,3.0,1.662162162162162,0.8648648648648649,,0.0,1.0,0.0,1.0,-5
2018, Elman FC , Horseed S.C ,2,3,-1,1,Loss,1,1,2,2,2,2,4,1.8493150684931507,1.3287671232876712,1.4583333333333333,1.1805555555555556,,3.0,2.0,0.25,0.25,-1
2018, Waxool FC , Heegan S.C ,0,7,-7,7,Loss,2,4,0,3,3,0,0,1.1142857142857143,2.142857142857143,1.917808219178082,0.8767123287671232,,,1.0,0.0,1.0,-7
2019, Dekedda SC , Gaadiidka FC ,1,1,0,0,Draw,2,2,3,0,0,3,5,1.7333333333333334,1.04,1.588235294117647,1.5441176470588236,0.0,2.0,1.0,0.375,0.0,0
2019, Jeenyo  FC , Mogadishu City Club ,1,0,1,-1,Win,1,3,1,2,2,1,4,1.4366197183098592,1.5211267605633803,1.96,0.7333333333333333,1.0,2.0,1.0,0.14285714285714285,0.2857142857142857,1
2019, Heegan S.C , Madbacadda FC ,1,0,1,-1,Win,4,1,0,1,1,0,1,1.5789473684210527,0.8947368421052632,0.9166666666666666,1.5833333333333333,1.0,5.0,2.0,0.0,0.5,1
2019, Jazeera SC , Midnimo FC ,0,1,-1,1,Loss,0,4,1,0,0,1,2,1.205128205128205,2.230769230769231,1.4878048780487805,1.2682926829268293,,,1.0,0.3333333333333333,0.0,-1
2019, Horseed S.C , Elman FC ,0,0,0,0,Draw,2,1,2,2,2,2,4,1.5714285714285714,0.935064935064935,1.75,1.144736842105263,0.0,1.0,1.0,0.25,0.25,0
2019, Jeenyo  FC , Dekedda SC ,2,8,-6,6,Loss,2,2,2,3,3,2,4,1.4366197183098592,1.5211267605633803,1.662162162162162,0.8648648648648649,,2.0,1.0,0.2222222222222222,0.3333333333333333,-6
2019, Gaadiidka FC , Madbacadda FC ,0,0,0,0,Draw,2,1,1,0,0,1,0,1.2272727272727273,1.3333333333333333,0.9166666666666666,1.5833333333333333,0.0,1.0,2.0,1.0,0.0,0
2019, Mogadishu City Club , Midnimo FC ,1,1,0,0,Draw,3,5,0,0,0,0,0,1.7671232876712328,0.9041095890410958,1.4878048780487805,1.2682926829268293,0.0,2.0,0.0,,,0
2019, Heegan S.C , Elman FC ,1,3,-2,2,Loss,4,1,1,1,1,1,5,1.5789473684210527,0.8947368421052632,1.75,1.144736842105263,,4.0,0.0,0.14285714285714285,0.14285714285714285,-2
2019, Jazeera SC , Horseed S.C ,1,1,0,0,Draw,0,2,0,1,1,0,0,1.205128205128205,2.230769230769231,1.4583333333333333,1.1805555555555556,0.0,0.0,1.0,0.0,1.0,0
2019, Dekedda SC , Madbacadda FC ,1,0,1,-1,Win,3,1,1,0,0,1,0,1.7333333333333334,1.04,0.9166666666666666,1.5833333333333333,1.0,2.0,3.0,1.0,0.0,1
2019, Jeenyo  FC , Midnimo FC ,0,1,-1,1,Loss,2,4,0,0,0,0,0,1.4366197183098592,1.5211267605633803,1.4878048780487805,1.2682926829268293,,1.0,0.0,,,-1
2019, Gaadiidka FC , Elman FC ,1,3,-2,2,Loss,2,2,1,4,4,1,2,1.2272727272727273,1.3333333333333333,1.75,1.144736842105263,,1.0,0.0,0.14285714285714285,0.5714285714285714,-2
2019, Mogadishu City Club , Horseed S.C ,1,2,-1,1,Loss,3,2,5,1,1,5,3,1.7671232876712328,0.9041095890410958,1.4583333333333333,1.1805555555555556,,2.0,1.0,0.5555555555555556,0.1111111111111111,-1
2019, Heegan S.C , Jazeera SC ,3,0,3,-3,Win,3,0,1,0,0,1,0,1.5789473684210527,0.8947368421052632,1.605263157894737,2.0789473684210527,1.0,4.0,3.0,1.0,0.0,3
2019, Midnimo FC , Dekedda SC ,0,2,-2,2,Loss,4,4,0,0,0,0,0,1.4857142857142858,1.3714285714285714,1.662162162162162,0.8648648648648649,,3.0,0.0,,,-2
2019, Madbacadda FC , Elman FC ,1,0,1,-1,Win,0,3,0,1,1,0,1,0.8,1.72,1.75,1.144736842105263,1.0,1.0,1.0,0.0,0.5,1
2019, Jeenyo  FC , Horseed S.C ,0,4,-4,4,Loss,1,3,3,1,1,3,3,1.4366197183098592,1.5211267605633803,1.4583333333333333,1.1805555555555556,,1.0,0.0,0.42857142857142855,0.14285714285714285,-4
2019, Gaadiidka FC , Jazeera SC ,0,1,-1,1,Loss,2,0,1,0,0,1,0,1.2272727272727273,1.3333333333333333,1.605263157894737,2.0789473684210527,,1.0,3.0,1.0,0.0,-1
2019, Mogadishu City Club , Heegan S.C ,1,0,1,-1,Win,2,3,1,1,1,1,7,1.7671232876712328,0.9041095890410958,1.917808219178082,0.8767123287671232,1.0,2.0,2.0,0.1111111111111111,0.1111111111111111,1
2019, Dekedda SC , Elman FC ,1,0,1,-1,Win,4,2,3,3,3,3,2,1.7333333333333334,1.04,1.75,1.144736842105263,1.0,2.0,2.0,0.375,0.375,1
2019, Midnimo FC , Horseed S.C ,0,2,-2,2,Loss,3,3,0,0,0,0,0,1.4857142857142858,1.3714285714285714,1.4583333333333333,1.1805555555555556,,2.0,0.0,,,-2
2019, Madbacadda FC , Jazeera SC ,1,2,-1,1,Loss,1,1,0,0,0,0,0,0.8,1.72,1.605263157894737,2.0789473684210527,,1.0,3.0,,,-1
2019, Jeenyo  FC , Heegan S.C ,0,2,-2,2,Loss,1,3,1,3,3,1,5,1.4366197183098592,1.5211267605633803,1.917808219178082,0.8767123287671232,,1.0,2.0,0.1111111111111111,0.3333333333333333,-2
2019, Gaadiidka FC , Mogadishu City Club ,1,2,-1,1,Loss,1,2,1,4,4,1,2,1.2272727272727273,1.3333333333333333,1.96,0.7333333333333333,,1.0,1.0,0.14285714285714285,0.5714285714285714,-1
2019, Horseed S.C , Dekedda SC ,1,0,1,-1,Win,3,4,1,2,2,1,5,1.5714285714285714,0.935064935064935,1.662162162162162,0.8648648648648649,1.0,2.0,1.0,0.125,0.25,1
2019, Elman FC , Jazeera SC ,3,2,1,-1,Win,2,2,1,0,0,1,0,1.8493150684931507,1.3287671232876712,1.605263157894737,2.0789473684210527,1.0,4.0,3.0,1.0,0.0,1
2019, Midnimo FC , Heegan S.C ,1,3,-2,2,Loss,2,3,0,0,0,0,0,1.4857142857142858,1.3714285714285714,1.917808219178082,0.8767123287671232,,2.0,1.0,,,-2
2019, Madbacadda FC , Mogadishu City Club ,1,4,-3,3,Loss,1,2,0,1,1,0,1,0.8,1.72,1.96,0.7333333333333333,,1.0,1.0,0.0,0.5,-3
2019, Jeenyo  FC , Gaadiidka FC ,2,4,-2,2,Loss,1,0,2,2,2,2,3,1.4366197183098592,1.5211267605633803,1.588235294117647,1.5441176470588236,,,1.0,0.2857142857142857,0.2857142857142857,-2
2019, Dekedda SC , Jazeera SC ,2,1,1,-1,Win,4,2,1,0,0,1,0,1.7333333333333334,1.04,1.605263157894737,2.0789473684210527,1.0,3.0,3.0,1.0,0.0,1
2019, Horseed S.C , Heegan S.C ,0,1,-1,1,Loss,4,3,2,4,4,2,5,1.5714285714285714,0.935064935064935,1.917808219178082,0.8767123287671232,,1.0,1.0,0.18181818181818182,0.36363636363636365,-1
2019, Elman FC , Mogadishu City Club ,1,1,0,0,Draw,3,3,0,2,2,0,5,1.8493150684931507,1.3287671232876712,1.96,0.7333333333333333,0.0,3.0,1.0,0.0,0.2857142857142857,0
2019, Midnimo FC , Gaadiidka FC ,0,2,-2,2,Loss,1,1,0,0,0,0,0,1.4857142857142858,1.3714285714285714,1.588235294117647,1.5441176470588236,,1.0,1.0,,,-2
2019, Madbacadda FC , Jeenyo  FC ,2,1,1,-1,Win,1,0,0,0,0,0,2,0.8,1.72,1.5846153846153845,1.4,1.0,2.0,3.0,0.0,0.0,1
2019, Heegan S.C , Dekedda SC ,1,1,0,0,Draw,4,4,2,1,1,2,4,1.5789473684210527,0.8947368421052632,1.662162162162162,0.8648648648648649,0.0,3.0,1.0,0.2857142857142857,0.14285714285714285,0
2019, Jazeera SC , Mogadishu City Club ,2,5,-3,3,Loss,2,3,0,1,1,0,0,1.205128205128205,2.230769230769231,1.96,0.7333333333333333,,0.0,1.0,0.0,1.0,-3
2019, Horseed S.C , Gaadiidka FC ,6,0,6,-6,Win,4,2,2,0,0,2,4,1.5714285714285714,0.935064935064935,1.588235294117647,1.5441176470588236,1.0,2.0,1.0,0.3333333333333333,0.0,6
2019, Elman FC , Jeenyo  FC ,3,1,2,-2,Win,2,0,1,0,0,1,7,1.8493150684931507,1.3287671232876712,1.5846153846153845,1.4,1.0,3.0,4.0,0.125,0.0,2
2019, Midnimo FC , Madbacadda FC ,1,0,1,-1,Win,1,2,0,0,0,0,0,1.4857142857142858,1.3714285714285714,0.9166666666666666,1.5833333333333333,1.0,1.0,4.0,,,1
2019, Dekedda SC , Mogadishu City Club ,1,0,1,-1,Win,3,4,2,1,1,2,5,1.7333333333333334,1.04,1.96,0.7333333333333333,1.0,4.0,1.0,0.25,0.125,1
2019, Heegan S.C , Gaadiidka FC ,4,0,4,-4,Win,3,2,4,0,0,4,1,1.5789473684210527,0.8947368421052632,1.588235294117647,1.5441176470588236,1.0,3.0,2.0,0.8,0.0,4
2019, Jeenyo  FC , Jazeera SC ,0,1,-1,1,Loss,0,2,0,0,0,0,1,1.4366197183098592,1.5211267605633803,1.605263157894737,2.0789473684210527,,,2.0,0.0,0.0,-1
2019, Horseed S.C , Madbacadda FC ,4,0,4,-4,Win,4,2,0,0,0,0,2,1.5714285714285714,0.935064935064935,0.9166666666666666,1.5833333333333333,1.0,3.0,4.0,0.0,0.0,4
2019, Elman FC , Midnimo FC ,1,2,-1,1,Loss,2,1,0,0,0,0,0,1.8493150684931507,1.3287671232876712,1.4878048780487805,1.2682926829268293,,2.0,0.0,,,-1
2019, Gaadiidka FC , Dekedda SC ,0,4,-4,4,Loss,2,3,0,3,3,0,6,1.2272727272727273,1.3333333333333333,1.662162162162162,0.8648648648648649,,0.0,1.0,0.0,0.3333333333333333,-4
2019, Jeenyo  FC , Mogadishu City Club ,0,4,-4,4,Loss,0,3,2,2,2,2,4,1.4366197183098592,1.5211267605633803,1.96,0.7333333333333333,,,1.0,0.25,0.25,-4
2019, Madbacadda FC , Heegan S.C ,3,4,-1,1,Loss,1,4,1,1,1,1,1,0.8,1.72,1.917808219178082,0.8767123287671232,,2.0,1.0,0.3333333333333333,0.3333333333333333,-1
2019, Midnimo FC , Jazeera SC ,2,2,0,0,Draw,2,2,0,1,1,0,2,1.4857142857142858,1.3714285714285714,1.605263157894737,2.0789473684210527,0.0,1.0,2.0,0.0,0.3333333333333333,0
2019, Elman FC , Horseed S.C ,2,1,1,-1,Win,2,4,2,2,2,2,5,1.8493150684931507,1.3287671232876712,1.4583333333333333,1.1805555555555556,1.0,3.0,1.0,0.2222222222222222,0.2222222222222222,1
2019, Dekedda SC , Jeenyo  FC ,4,1,3,-3,Win,3,0,3,2,2,3,4,1.7333333333333334,1.04,1.5846153846153845,1.4,1.0,5.0,4.0,0.3333333333333333,0.2222222222222222,3
2019, Madbacadda FC , Gaadiidka FC ,0,2,-2,2,Loss,1,2,0,1,1,0,1,0.8,1.72,1.588235294117647,1.5441176470588236,,1.0,2.0,0.0,0.5,-2
2019, Elman FC , Heegan S.C ,2,1,1,-1,Win,3,4,1,1,1,1,5,1.8493150684931507,1.3287671232876712,1.917808219178082,0.8767123287671232,1.0,3.0,1.0,0.14285714285714285,0.14285714285714285,1
2019, Horseed S.C , Jazeera SC ,3,1,2,-2,Win,3,1,1,0,0,1,1,1.5714285714285714,0.935064935064935,1.605263157894737,2.0789473684210527,1.0,4.0,3.0,0.5,0.0,2
2019, Madbacadda FC , Dekedda SC ,0,2,-2,2,Loss,1,4,0,2,2,0,0,0.8,1.72,1.662162162162162,0.8648648648648649,,1.0,1.0,0.0,1.0,-2
2019, Midnimo FC , Jeenyo  FC ,0,0,0,0,Draw,2,0,0,0,0,0,0,1.4857142857142858,1.3714285714285714,1.5846153846153845,1.4,0.0,1.0,4.0,,,0
2019, Elman FC , Gaadiidka FC ,3,1,2,-2,Win,3,2,4,1,1,4,2,1.8493150684931507,1.3287671232876712,1.588235294117647,1.5441176470588236,1.0,4.0,3.0,0.5714285714285714,0.14285714285714285,2
2019, Horseed S.C , Mogadishu City Club ,1,0,1,-1,Win,3,3,1,5,5,1,3,1.5714285714285714,0.935064935064935,1.96,0.7333333333333333,1.0,4.0,2.0,0.1111111111111111,0.5555555555555556,1
2019, Jazeera SC , Heegan S.C ,0,0,0,0,Draw,1,3,0,2,2,0,0,1.205128205128205,2.230769230769231,1.917808219178082,0.8767123287671232,0.0,0.0,1.0,0.0,1.0,0
2019, Elman FC , Madbacadda FC ,1,1,0,0,Draw,4,0,1,1,1,1,1,1.8493150684931507,1.3287671232876712,0.9166666666666666,1.5833333333333333,0.0,3.0,3.0,0.3333333333333333,0.3333333333333333,0
2019, Dekedda SC , Midnimo FC ,1,0,1,-1,Win,4,2,0,0,0,0,0,1.7333333333333334,1.04,1.4878048780487805,1.2682926829268293,1.0,5.0,1.0,,,1
2019, Horseed S.C , Jeenyo  FC ,3,0,3,-3,Win,4,0,1,3,3,1,3,1.5714285714285714,0.935064935064935,1.5846153846153845,1.4,1.0,5.0,4.0,0.14285714285714285,0.42857142857142855,3
2019, Jazeera SC , Gaadiidka FC ,2,2,0,0,Draw,1,1,0,1,1,0,0,1.205128205128205,2.230769230769231,1.588235294117647,1.5441176470588236,0.0,0.0,3.0,0.0,1.0,0
2019, Heegan S.C , Mogadishu City Club ,0,0,0,0,Draw,2,2,1,2,2,1,7,1.5789473684210527,0.8947368421052632,1.96,0.7333333333333333,0.0,2.0,2.0,0.1,0.2,0
2019, Elman FC , Dekedda SC ,2,0,2,-2,Win,3,5,3,4,4,3,2,1.8493150684931507,1.3287671232876712,1.662162162162162,0.8648648648648649,1.0,4.0,2.0,0.3333333333333333,0.4444444444444444,2
2019, Horseed S.C , Midnimo FC ,3,0,3,-3,Win,4,2,0,0,0,0,0,1.5714285714285714,0.935064935064935,1.4878048780487805,1.2682926829268293,1.0,5.0,2.0,,,3
2019, Jazeera SC , Madbacadda FC ,0,0,0,0,Draw,1,0,0,0,0,0,0,1.205128205128205,2.230769230769231,0.9166666666666666,1.5833333333333333,0.0,0.0,3.0,,,0
2019, Heegan S.C , Jeenyo  FC ,1,1,0,0,Draw,2,0,3,1,1,3,5,1.5789473684210527,0.8947368421052632,1.5846153846153845,1.4,0.0,2.0,3.0,0.3333333333333333,0.1111111111111111,0
2019, Mogadishu City Club , Gaadiidka FC ,1,0,1,-1,Win,2,1,4,1,1,4,2,1.7671232876712328,0.9041095890410958,1.588235294117647,1.5441176470588236,1.0,2.0,3.0,0.5714285714285714,0.14285714285714285,1
2019, Dekedda SC , Horseed S.C ,1,1,0,0,Draw,4,4,2,2,2,2,5,1.7333333333333334,1.04,1.4583333333333333,1.1805555555555556,0.0,4.0,1.0,0.2222222222222222,0.2222222222222222,0
2019, Jazeera SC , Elman FC ,2,2,0,0,Draw,0,4,0,2,2,0,0,1.205128205128205,2.230769230769231,1.75,1.144736842105263,0.0,0.0,2.0,0.0,1.0,0
2019, Heegan S.C , Midnimo FC ,2,0,2,-2,Win,1,1,0,0,0,0,0,1.5789473684210527,0.8947368421052632,1.4878048780487805,1.2682926829268293,1.0,2.0,3.0,,,2
2019, Mogadishu City Club , Madbacadda FC ,0,0,0,0,Draw,2,0,1,0,0,1,1,1.7671232876712328,0.9041095890410958,0.9166666666666666,1.5833333333333333,0.0,2.0,2.0,0.5,0.0,0
2019, Gaadiidka FC , Jeenyo  FC ,2,1,1,-1,Win,1,0,2,2,2,2,3,1.2272727272727273,1.3333333333333333,1.5846153846153845,1.4,1.0,1.0,3.0,0.2857142857142857,0.2857142857142857,1
2019, Jazeera SC , Dekedda SC ,1,4,-3,3,Loss,0,3,0,2,2,0,0,1.205128205128205,2.230769230769231,1.662162162162162,0.8648648648648649,,0.0,1.0,0.0,1.0,-3
2019, Heegan S.C , Horseed S.C ,1,1,0,0,Draw,1,4,4,2,2,4,5,1.5789473684210527,0.8947368421052632,1.4583333333333333,1.1805555555555556,0.0,2.0,1.0,0.36363636363636365,0.18181818181818182,0
2019, Mogadishu City Club , Elman FC ,2,2,0,0,Draw,2,3,2,0,0,2,6,1.7671232876712328,0.9041095890410958,1.75,1.144736842105263,0.0,2.0,2.0,0.25,0.0,0
2019, Gaadiidka FC , Midnimo FC ,1,0,1,-1,Win,2,0,0,0,0,0,0,1.2272727272727273,1.3333333333333333,1.4878048780487805,1.2682926829268293,1.0,2.0,4.0,,,1
2019, Jeenyo  FC , Madbacadda FC ,2,4,-2,2,Loss,0,0,0,1,1,0,2,1.4366197183098592,1.5211267605633803,0.9166666666666666,1.5833333333333333,,,1.0,0.0,0.3333333333333333,-2
2019, Dekedda SC , Heegan S.C ,1,0,1,-1,Win,3,1,1,2,2,1,5,1.7333333333333334,1.04,1.917808219178082,0.8767123287671232,1.0,4.0,2.0,0.125,0.25,1
2019, Mogadishu City Club , Jazeera SC ,4,5,-1,1,Loss,1,0,1,0,0,1,0,1.7671232876712328,0.9041095890410958,1.605263157894737,2.0789473684210527,,2.0,2.0,1.0,0.0,-1
2019, Gaadiidka FC , Horseed S.C ,0,3,-3,3,Loss,2,3,0,3,3,0,4,1.2272727272727273,1.3333333333333333,1.4583333333333333,1.1805555555555556,,2.0,1.0,0.0,0.42857142857142855,-3
2019, Jeenyo  FC , Elman FC ,2,6,-4,4,Loss,0,2,0,2,2,0,7,1.4366197183098592,1.5211267605633803,1.75,1.144736842105263,,,2.0,0.0,0.2222222222222222,-4
2019, Madbacadda FC , Midnimo FC ,0,1,-1,1,Loss,1,0,0,1,1,0,0,0.8,1.72,1.4878048780487805,1.2682926829268293,,1.0,4.0,0.0,1.0,-1
2019, Mogadishu City Club , Dekedda SC ,2,3,-1,1,Loss,1,3,1,3,3,1,5,1.7671232876712328,0.9041095890410958,1.662162162162162,0.8648648648648649,,1.0,1.0,0.1111111111111111,0.3333333333333333,-1
2019, Gaadiidka FC , Heegan S.C ,0,1,-1,1,Loss,2,1,0,5,5,0,1,1.2272727272727273,1.3333333333333333,1.917808219178082,0.8767123287671232,,2.0,2.0,0.0,0.8333333333333334,-1
2019, Jeenyo  FC , Jazeera SC ,2,4,-2,2,Loss,0,1,0,0,0,0,1,1.4366197183098592,1.5211267605633803,1.605263157894737,2.0789473684210527,,,1.0,0.0,0.0,-2
2019, Madbacadda FC , Horseed S.C ,0,3,-3,3,Loss,1,3,0,1,1,0,2,0.8,1.72,1.4583333333333333,1.1805555555555556,,,1.0,0.0,0.3333333333333333,-3
2019, Midnimo FC , Elman FC ,0,0,0,0,Draw,1,2,0,0,0,0,0,1.4857142857142858,1.3714285714285714,1.75,1.144736842105263,0.0,1.0,1.0,,,0
2019, Dekedda SC , Midnimo FC ,1,1,0,0,Draw,3,1,1,0,0,1,0,1.7333333333333334,1.04,1.4878048780487805,1.2682926829268293,0.0,3.0,3.0,1.0,0.0,0
2019, Raadsan FC , Gaadiidka FC ,3,0,3,-3,Win,4,2,0,0,0,0,0,1.7407407407407407,1.4074074074074074,1.588235294117647,1.5441176470588236,1.0,4.0,3.0,,,3
2019, Mogadishu City Club , Rajo FC ,1,2,-1,1,Loss,1,0,0,0,0,0,0,1.7671232876712328,0.9041095890410958,1.6,2.8,,0.0,,,,-1
2019, Elman FC , Heegan S.C ,1,1,0,0,Draw,2,2,2,1,1,2,5,1.8493150684931507,1.3287671232876712,1.917808219178082,0.8767123287671232,0.0,3.0,2.0,0.25,0.125,0
2019, Horseed S.C , Jazeera SC ,1,1,0,0,Draw,3,2,2,0,0,2,1,1.5714285714285714,0.935064935064935,1.605263157894737,2.0789473684210527,0.0,4.0,1.0,0.6666666666666666,0.0,0
2020, Gaadiidka FC , Dekedda SC ,0,1,-1,1,Loss,2,3,0,3,3,0,6,1.2272727272727273,1.3333333333333333,1.662162162162162,0.8648648648648649,,2.0,1.0,0.0,0.3333333333333333,-1
2020, Midnimo FC , Heegan S.C ,0,2,-2,2,Loss,1,2,0,1,1,0,0,1.4857142857142858,1.3714285714285714,1.917808219178082,0.8767123287671232,,1.0,1.0,0.0,1.0,-2
2020, Raadsan FC , Rajo FC ,2,2,0,0,Draw,4,1,0,0,0,0,0,1.7407407407407407,1.4074074074074074,1.6,2.8,0.0,3.0,0.0,,,0
2020, Elman FC , Jazeera SC ,4,1,3,-3,Win,1,2,2,0,0,2,1,1.8493150684931507,1.3287671232876712,1.605263157894737,2.0789473684210527,1.0,3.0,2.0,0.6666666666666666,0.0,3
2020, Mogadishu City Club , Horseed S.C ,0,0,0,0,Draw,0,2,5,2,2,5,3,1.7671232876712328,0.9041095890410958,1.4583333333333333,1.1805555555555556,0.0,0.0,0.0,0.5,0.2,0
2020, Dekedda SC , Heegan S.C ,2,1,1,-1,Win,4,2,2,2,2,2,5,1.7333333333333334,1.04,1.917808219178082,0.8767123287671232,1.0,3.0,2.0,0.2222222222222222,0.2222222222222222,1
2020, Gaadiidka FC , Rajo FC ,3,1,2,-2,Win,1,1,0,0,0,0,0,1.2272727272727273,1.3333333333333333,1.6,2.8,1.0,2.0,1.0,,,2
2020, Midnimo FC , Jazeera SC ,3,0,3,-3,Win,1,2,0,1,1,0,3,1.4857142857142858,1.3714285714285714,1.605263157894737,2.0789473684210527,1.0,1.0,2.0,0.0,0.25,3
2020, Raadsan FC , Horseed S.C ,2,4,-2,2,Loss,3,2,0,0,0,0,0,1.7407407407407407,1.4074074074074074,1.4583333333333333,1.1805555555555556,,2.0,0.0,,,-2
2020, Elman FC , Mogadishu City Club ,1,1,0,0,Draw,2,0,0,2,2,0,7,1.8493150684931507,1.3287671232876712,1.96,0.7333333333333333,0.0,2.0,2.0,0.0,0.2222222222222222,0
2020, Rajo FC , Dekedda SC ,0,2,-2,2,Loss,1,4,0,0,0,0,0,0.375,3.625,1.662162162162162,0.8648648648648649,,,1.0,,,-2
2020, Heegan S.C , Jazeera SC ,2,0,2,-2,Win,2,2,2,0,0,2,1,1.5789473684210527,0.8947368421052632,1.605263157894737,2.0789473684210527,1.0,2.0,3.0,0.6666666666666666,0.0,2
2020, Gaadiidka FC , Horseed S.C ,0,1,-1,1,Loss,1,3,0,3,3,0,4,1.2272727272727273,1.3333333333333333,1.4583333333333333,1.1805555555555556,,1.0,0.0,0.0,0.42857142857142855,-1
2020, Midnimo FC , Mogadishu City Club ,0,4,-4,4,Loss,2,0,0,0,0,0,1,1.4857142857142858,1.3714285714285714,1.96,0.7333333333333333,,1.0,1.0,0.0,0.0,-4
2020, Raadsan FC , Elman FC ,2,3,-1,1,Loss,3,2,0,0,0,0,0,1.7407407407407407,1.4074074074074074,1.75,1.144736842105263,,1.0,0.0,,,-1
2020, Dekedda SC , Jazeera SC ,2,1,1,-1,Win,4,1,2,0,0,2,0,1.7333333333333334,1.04,1.605263157894737,2.0789473684210527,1.0,3.0,4.0,1.0,0.0,1
2020, Rajo FC , Horseed S.C ,0,2,-2,2,Loss,1,3,0,0,0,0,0,0.375,3.625,1.4583333333333333,1.1805555555555556,,,0.0,,,-2
2020, Heegan S.C , Mogadishu City Club ,0,3,-3,3,Loss,3,1,1,2,2,1,8,1.5789473684210527,0.8947368421052632,1.96,0.7333333333333333,,2.0,1.0,0.09090909090909091,0.18181818181818182,-3
2020, Gaadiidka FC , Elman FC ,1,3,-2,2,Loss,1,2,1,5,5,1,2,1.2272727272727273,1.3333333333333333,1.75,1.144736842105263,,1.0,0.0,0.125,0.625,-2
2020, Midnimo FC , Raadsan FC ,0,3,-3,3,Loss,1,2,1,0,0,1,1,1.4857142857142858,1.3714285714285714,1.59375,1.46875,,1.0,1.0,0.5,0.0,-3
2020, Horseed S.C , Dekedda SC ,0,0,0,0,Draw,3,4,2,2,2,2,6,1.5714285714285714,0.935064935064935,1.662162162162162,0.8648648648648649,0.0,3.0,0.0,0.2,0.2,0
2020, Jazeera SC , Mogadishu City Club ,1,3,-2,2,Loss,0,2,0,1,1,0,0,1.205128205128205,2.230769230769231,1.96,0.7333333333333333,,0.0,0.0,0.0,1.0,-2
2020, Rajo FC , Elman FC ,1,6,-5,5,Loss,1,3,0,0,0,0,0,0.375,3.625,1.75,1.144736842105263,,,0.0,,,-5
2020, Heegan S.C , Raadsan FC ,2,1,1,-1,Win,2,2,0,0,0,0,0,1.5789473684210527,0.8947368421052632,1.59375,1.46875,1.0,3.0,2.0,,,1
2020, Gaadiidka FC , Midnimo FC ,0,2,-2,2,Loss,1,1,1,0,0,1,0,1.2272727272727273,1.3333333333333333,1.4878048780487805,1.2682926829268293,,1.0,2.0,1.0,0.0,-2
2020, Dekedda SC , Mogadishu City Club ,0,5,-5,5,Loss,4,3,3,1,1,3,5,1.7333333333333334,1.04,1.96,0.7333333333333333,,3.0,0.0,0.3333333333333333,0.1111111111111111,-5
2020, Horseed S.C , Elman FC ,2,3,-1,1,Loss,3,4,2,3,3,2,5,1.5714285714285714,0.935064935064935,1.75,1.144736842105263,,2.0,0.0,0.2,0.3,-1
2020, Jazeera SC , Raadsan FC ,2,2,0,0,Draw,0,1,0,1,1,0,0,1.205128205128205,2.230769230769231,1.59375,1.46875,0.0,0.0,1.0,0.0,1.0,0
2020, Rajo FC , Midnimo FC ,1,1,0,0,Draw,0,2,0,0,0,0,0,0.375,3.625,1.4878048780487805,1.2682926829268293,0.0,0.0,1.0,,,0
2020, Heegan S.C , Gaadiidka FC ,1,1,0,0,Draw,3,1,5,0,0,5,1,1.5789473684210527,0.8947368421052632,1.588235294117647,1.5441176470588236,0.0,2.0,3.0,0.8333333333333334,0.0,0
2020, Elman FC , Dekedda SC ,0,1,-1,1,Loss,4,3,4,4,4,4,2,1.8493150684931507,1.3287671232876712,1.662162162162162,0.8648648648648649,,2.0,0.0,0.4,0.4,-1
2020, Mogadishu City Club , Raadsan FC ,2,3,-1,1,Loss,4,1,0,0,0,0,0,1.7671232876712328,0.9041095890410958,1.59375,1.46875,,0.0,1.0,,,-1
2020, Horseed S.C , Midnimo FC ,1,0,1,-1,Win,3,2,1,0,0,1,0,1.5714285714285714,0.935064935064935,1.4878048780487805,1.2682926829268293,1.0,2.0,1.0,1.0,0.0,1
2020, Jazeera SC , Gaadiidka FC ,1,1,0,0,Draw,0,1,0,1,1,0,1,1.205128205128205,2.230769230769231,1.588235294117647,1.5441176470588236,0.0,0.0,2.0,0.0,0.5,0
2020, Rajo FC , Heegan S.C ,1,2,-1,1,Loss,0,2,0,0,0,0,0,0.375,3.625,1.917808219178082,0.8767123287671232,,0.0,1.0,,,-1
2020, Dekedda SC , Raadsan FC ,1,0,1,-1,Win,3,2,0,0,0,0,0,1.7333333333333334,1.04,1.59375,1.46875,1.0,3.0,2.0,,,1
2020, Elman FC , Midnimo FC ,1,1,0,0,Draw,4,1,0,0,0,0,1,1.8493150684931507,1.3287671232876712,1.4878048780487805,1.2682926829268293,0.0,1.0,1.0,0.0,0.0,0
2020, Mogadishu City Club , Gaadiidka FC ,3,0,3,-3,Win,4,0,5,1,1,5,2,1.7671232876712328,0.9041095890410958,1.588235294117647,1.5441176470588236,1.0,1.0,3.0,0.625,0.125,3
2020, Horseed S.C , Heegan S.C ,1,0,1,-1,Win,3,3,2,4,4,2,6,1.5714285714285714,0.935064935064935,1.917808219178082,0.8767123287671232,1.0,2.0,2.0,0.16666666666666666,0.3333333333333333,1
2020, Jazeera SC , Rajo FC ,4,2,2,-2,Win,0,0,0,0,0,0,0,1.205128205128205,2.230769230769231,1.6,2.8,1.0,1.0,2.0,,,2
2020, Midnimo FC , Dekedda SC ,0,0,0,0,Draw,1,3,0,1,1,0,1,1.4857142857142858,1.3714285714285714,1.662162162162162,0.8648648648648649,0.0,1.0,0.0,0.0,0.5,0
2020, Gaadiidka FC , Raadsan FC ,5,0,5,-5,Win,0,2,0,1,1,0,0,1.2272727272727273,1.3333333333333333,1.59375,1.46875,1.0,2.0,3.0,0.0,1.0,5
2020, Heegan S.C , Elman FC ,3,1,2,-2,Win,2,3,1,2,2,1,6,1.5789473684210527,0.8947368421052632,1.75,1.144736842105263,1.0,3.0,1.0,0.1111111111111111,0.2222222222222222,2
2020, Rajo FC , Mogadishu City Club ,0,5,-5,5,Loss,0,4,0,0,0,0,0,0.375,3.625,1.96,0.7333333333333333,,0.0,,,,-5
2020, Jazeera SC , Horseed S.C ,0,1,-1,1,Loss,1,3,0,2,2,0,2,1.205128205128205,2.230769230769231,1.4583333333333333,1.1805555555555556,,1.0,0.0,0.0,0.5,-1
2020, Dekedda SC , Gaadiidka FC ,1,3,-2,2,Loss,2,1,3,0,0,3,6,1.7333333333333334,1.04,1.588235294117647,1.5441176470588236,,3.0,2.0,0.3333333333333333,0.0,-2
2020, Heegan S.C , Midnimo FC ,0,1,-1,1,Loss,3,1,1,0,0,1,0,1.5789473684210527,0.8947368421052632,1.4878048780487805,1.2682926829268293,,2.0,1.0,1.0,0.0,-1
2020, Rajo FC , Raadsan FC ,0,4,-4,4,Loss,0,1,0,0,0,0,1,0.375,3.625,1.59375,1.46875,,0.0,2.0,0.0,0.0,-4
2020, Jazeera SC , Elman FC ,2,4,-2,2,Loss,1,2,0,3,3,0,1,1.205128205128205,2.230769230769231,1.75,1.144736842105263,,1.0,1.0,0.0,0.75,-2
2020, Horseed S.C , Mogadishu City Club ,0,0,0,0,Draw,3,4,2,5,5,2,4,1.5714285714285714,0.935064935064935,1.96,0.7333333333333333,0.0,2.0,0.0,0.18181818181818182,0.45454545454545453,0
2020, Heegan S.C , Dekedda SC ,1,0,1,-1,Win,2,2,2,3,3,2,5,1.5789473684210527,0.8947368421052632,1.662162162162162,0.8648648648648649,1.0,3.0,1.0,0.2,0.3,1
2020, Rajo FC , Gaadiidka FC ,0,7,-7,7,Loss,0,2,0,1,1,0,0,0.375,3.625,1.588235294117647,1.5441176470588236,,0.0,1.0,0.0,1.0,-7
2020, Jazeera SC , Midnimo FC ,1,2,-1,1,Loss,1,1,1,1,1,1,3,1.205128205128205,2.230769230769231,1.4878048780487805,1.2682926829268293,,1.0,1.0,0.2,0.2,-1
2020, Horseed S.C , Raadsan FC ,4,0,4,-4,Win,3,2,0,0,0,0,0,1.5714285714285714,0.935064935064935,1.59375,1.46875,1.0,3.0,3.0,,,4
2020, Mogadishu City Club , Elman FC ,2,0,2,-2,Win,3,2,2,0,0,2,8,1.7671232876712328,0.9041095890410958,1.75,1.144736842105263,1.0,2.0,2.0,0.2,0.0,2
2020, Dekedda SC , Rajo FC ,4,1,3,-3,Win,2,0,0,0,0,0,0,1.7333333333333334,1.04,1.6,2.8,1.0,3.0,3.0,,,3
2020, Jazeera SC , Heegan S.C ,0,3,-3,3,Loss,1,3,0,3,3,0,1,1.205128205128205,2.230769230769231,1.917808219178082,0.8767123287671232,,1.0,2.0,0.0,0.75,-3
2020, Horseed S.C , Gaadiidka FC ,0,1,-1,1,Loss,4,3,3,0,0,3,4,1.5714285714285714,0.935064935064935,1.588235294117647,1.5441176470588236,,3.0,1.0,0.42857142857142855,0.0,-1
2020, Mogadishu City Club , Midnimo FC ,2,1,1,-1,Win,3,2,0,0,0,0,1,1.7671232876712328,0.9041095890410958,1.4878048780487805,1.2682926829268293,1.0,3.0,2.0,0.0,0.0,1
2020, Elman FC , Raadsan FC ,2,1,1,-1,Win,1,2,0,0,0,0,0,1.8493150684931507,1.3287671232876712,1.59375,1.46875,1.0,2.0,4.0,,,1
2021, Heegan S.C , Midnimo FC ,1,0,1,-1,Win,3,2,1,0,0,1,0,1.5789473684210527,0.8947368421052632,1.4878048780487805,1.2682926829268293,1.0,3.0,2.0,1.0,0.0,1
2021, Geeska Afrika FC , Jeenyo  FC ,0,0,0,0,Draw,2,0,0,0,0,0,0,1.0434782608695652,2.9130434782608696,1.5846153846153845,1.4,0.0,3.0,2.0,,,0
2021, Raadsan FC , Horseed S.C ,1,0,1,-1,Win,1,3,0,1,1,0,0,1.7407407407407407,1.4074074074074074,1.4583333333333333,1.1805555555555556,1.0,2.0,1.0,0.0,1.0,1
2021, Elman FC , Mogadishu City Club ,0,1,-1,1,Loss,2,4,0,3,3,0,8,1.8493150684931507,1.3287671232876712,1.96,0.7333333333333333,,1.0,0.0,0.0,0.2727272727272727,-1
2021, Dekedda SC , Gaadiidka FC ,1,1,0,0,Draw,2,4,3,0,0,3,6,1.7333333333333334,1.04,1.588235294117647,1.5441176470588236,0.0,2.0,1.0,0.3333333333333333,0.0,0
2021, Jeenyo  FC , Heegan S.C ,1,2,-1,1,Loss,0,4,1,3,3,1,6,1.4366197183098592,1.5211267605633803,1.917808219178082,0.8767123287671232,,,2.0,0.1,0.3,-1
2021, Midnimo FC , Horseed S.C ,0,2,-2,2,Loss,2,2,0,2,2,0,0,1.4857142857142858,1.3714285714285714,1.4583333333333333,1.1805555555555556,,1.0,1.0,0.0,1.0,-2
2021, Geeska Afrika FC , Mogadishu City Club ,0,2,-2,2,Loss,2,4,0,0,0,0,0,1.0434782608695652,2.9130434782608696,1.96,0.7333333333333333,,2.0,0.0,,,-2
2021, Raadsan FC , Gaadiidka FC ,1,0,1,-1,Win,2,4,1,1,1,1,0,1.7407407407407407,1.4074074074074074,1.588235294117647,1.5441176470588236,1.0,2.0,1.0,0.5,0.5,1
2021, Elman FC , Dekedda SC ,2,1,1,-1,Win,2,1,4,4,4,4,2,1.8493150684931507,1.3287671232876712,1.662162162162162,0.8648648648648649,1.0,2.0,2.0,0.4,0.4,1
2021, Heegan S.C , Horseed S.C ,1,1,0,0,Draw,4,2,4,3,3,4,6,1.5789473684210527,0.8947368421052632,1.4583333333333333,1.1805555555555556,0.0,3.0,1.0,0.3076923076923077,0.23076923076923078,0
2021, Jeenyo  FC , Mogadishu City Club ,1,0,1,-1,Win,0,4,2,2,2,2,4,1.4366197183098592,1.5211267605633803,1.96,0.7333333333333333,1.0,1.0,1.0,0.25,0.25,1
2021, Midnimo FC , Gaadiidka FC ,1,1,0,0,Draw,2,3,0,1,1,0,0,1.4857142857142858,1.3714285714285714,1.588235294117647,1.5441176470588236,0.0,0.0,1.0,0.0,1.0,0
2021, Geeska Afrika FC , Dekedda SC ,0,3,-3,3,Loss,1,1,0,0,0,0,0,1.0434782608695652,2.9130434782608696,1.662162162162162,0.8648648648648649,,1.0,2.0,,,-3
2021, Raadsan FC , Elman FC ,1,0,1,-1,Win,3,3,0,1,1,0,0,1.7407407407407407,1.4074074074074074,1.75,1.144736842105263,1.0,3.0,3.0,0.0,1.0,1
2021, Mogadishu City Club , Heegan S.C ,3,2,1,-1,Win,4,4,2,1,1,2,8,1.7671232876712328,0.9041095890410958,1.917808219178082,0.8767123287671232,1.0,4.0,2.0,0.18181818181818182,0.09090909090909091,1
2021, Horseed S.C , Gaadiidka FC ,1,3,-2,2,Loss,2,2,3,0,0,3,4,1.5714285714285714,0.935064935064935,1.588235294117647,1.5441176470588236,,2.0,1.0,0.42857142857142855,0.0,-2
2021, Jeenyo  FC , Dekedda SC ,0,4,-4,4,Loss,1,2,2,4,4,2,4,1.4366197183098592,1.5211267605633803,1.662162162162162,0.8648648648648649,,1.0,2.0,0.2,0.4,-4
2021, Midnimo FC , Elman FC ,1,0,1,-1,Win,1,2,0,0,0,0,2,1.4857142857142858,1.3714285714285714,1.75,1.144736842105263,1.0,1.0,4.0,0.0,0.0,1
2021, Geeska Afrika FC , Raadsan FC ,0,2,-2,2,Loss,1,3,1,1,1,1,1,1.0434782608695652,2.9130434782608696,1.59375,1.46875,,1.0,3.0,0.3333333333333333,0.3333333333333333,-2
2021, Heegan S.C , Gaadiidka FC ,3,0,3,-3,Win,3,2,5,0,0,5,2,1.5789473684210527,0.8947368421052632,1.588235294117647,1.5441176470588236,1.0,3.0,2.0,0.7142857142857143,0.0,3
2021, Mogadishu City Club , Dekedda SC ,1,0,1,-1,Win,4,3,1,3,3,1,5,1.7671232876712328,0.9041095890410958,1.662162162162162,0.8648648648648649,1.0,5.0,3.0,0.1111111111111111,0.3333333333333333,1
2021, Horseed S.C , Elman FC ,3,0,3,-3,Win,1,2,2,3,3,2,5,1.5714285714285714,0.935064935064935,1.75,1.144736842105263,1.0,2.0,4.0,0.2,0.3,3
2021, Jeenyo  FC , Raadsan FC ,1,1,0,0,Draw,1,4,0,0,0,0,0,1.4366197183098592,1.5211267605633803,1.59375,1.46875,0.0,1.0,2.0,,,0
2021, Midnimo FC , Geeska Afrika FC ,2,1,1,-1,Win,1,0,2,2,2,2,0,1.4857142857142858,1.3714285714285714,1.2173913043478262,2.5217391304347827,1.0,2.0,4.0,0.5,0.5,1
2021, Dekedda SC , Heegan S.C ,0,0,0,0,Draw,2,3,3,3,3,3,5,1.7333333333333334,1.04,1.917808219178082,0.8767123287671232,0.0,2.0,2.0,0.2727272727272727,0.2727272727272727,0
2021, Gaadiidka FC , Elman FC ,0,1,-1,1,Loss,1,1,1,5,5,1,2,1.2272727272727273,1.3333333333333333,1.75,1.144736842105263,,1.0,4.0,0.125,0.625,-1
2021, Mogadishu City Club , Raadsan FC ,1,0,1,-1,Win,4,4,0,0,0,0,0,1.7671232876712328,0.9041095890410958,1.59375,1.46875,1.0,5.0,3.0,,,1
2021, Horseed S.C , Geeska Afrika FC ,3,1,2,-2,Win,2,0,0,0,0,0,0,1.5714285714285714,0.935064935064935,1.2173913043478262,2.5217391304347827,1.0,3.0,4.0,,,2
2021, Jeenyo  FC , Midnimo FC ,1,0,1,-1,Win,1,2,0,0,0,0,1,1.4366197183098592,1.5211267605633803,1.4878048780487805,1.2682926829268293,1.0,2.0,3.0,0.0,0.0,1
2021, Heegan S.C , Elman FC ,1,0,1,-1,Win,2,2,2,2,2,2,6,1.5789473684210527,0.8947368421052632,1.75,1.144736842105263,1.0,4.0,4.0,0.2,0.2,1
2021, Dekedda SC , Raadsan FC ,1,2,-1,1,Loss,2,3,1,0,0,1,0,1.7333333333333334,1.04,1.59375,1.46875,,1.0,2.0,1.0,0.0,-1
2021, Gaadiidka FC , Geeska Afrika FC ,6,0,6,-6,Win,1,0,0,0,0,0,0,1.2272727272727273,1.3333333333333333,1.2173913043478262,2.5217391304347827,1.0,2.0,4.0,,,6
2021, Mogadishu City Club , Midnimo FC ,1,0,1,-1,Win,4,2,1,0,0,1,1,1.7671232876712328,0.9041095890410958,1.4878048780487805,1.2682926829268293,1.0,5.0,4.0,0.5,0.0,1
2021, Horseed S.C , Jeenyo  FC ,3,0,3,-3,Win,3,2,2,3,3,2,3,1.5714285714285714,0.935064935064935,1.5846153846153845,1.4,1.0,3.0,3.0,0.25,0.375,3
2021, Raadsan FC , Heegan S.C ,0,0,0,0,Draw,3,2,0,1,1,0,0,1.7407407407407407,1.4074074074074074,1.917808219178082,0.8767123287671232,0.0,3.0,1.0,0.0,1.0,0
2021, Elman FC , Geeska Afrika FC ,4,0,4,-4,Win,1,0,0,0,0,0,0,1.8493150684931507,1.3287671232876712,1.2173913043478262,2.5217391304347827,1.0,3.0,5.0,,,4
2021, Dekedda SC , Midnimo FC ,1,2,-1,1,Loss,2,2,1,0,0,1,2,1.7333333333333334,1.04,1.4878048780487805,1.2682926829268293,,1.0,4.0,0.3333333333333333,0.0,-1
2021, Gaadiidka FC , Jeenyo  FC ,2,2,0,0,Draw,2,2,3,2,2,3,3,1.2272727272727273,1.3333333333333333,1.5846153846153845,1.4,0.0,2.0,2.0,0.375,0.25,0
2021, Mogadishu City Club , Horseed S.C ,1,1,0,0,Draw,4,3,5,2,2,5,5,1.7671232876712328,0.9041095890410958,1.4583333333333333,1.1805555555555556,0.0,4.0,1.0,0.4166666666666667,0.16666666666666666,0
2021, Heegan S.C , Geeska Afrika FC ,1,1,0,0,Draw,2,0,0,0,0,0,0,1.5789473684210527,0.8947368421052632,1.2173913043478262,2.5217391304347827,0.0,3.0,4.0,,,0
2021, Raadsan FC , Midnimo FC ,1,0,1,-1,Win,2,3,0,1,1,0,1,1.7407407407407407,1.4074074074074074,1.4878048780487805,1.2682926829268293,1.0,4.0,4.0,0.0,0.5,1
2021, Elman FC , Jeenyo  FC ,1,2,-1,1,Loss,2,1,2,0,0,2,7,1.8493150684931507,1.3287671232876712,1.5846153846153845,1.4,,3.0,2.0,0.2222222222222222,0.0,-1
2021, Dekedda SC , Horseed S.C ,0,2,-2,2,Loss,1,3,2,2,2,2,7,1.7333333333333334,1.04,1.4583333333333333,1.1805555555555556,,0.0,1.0,0.18181818181818182,0.18181818181818182,-2
2021, Gaadiidka FC , Mogadishu City Club ,0,1,-1,1,Loss,2,4,1,6,6,1,2,1.2272727272727273,1.3333333333333333,1.96,0.7333333333333333,,2.0,1.0,0.1111111111111111,0.6666666666666666,-1
2021, Heegan S.C , Midnimo FC ,2,1,1,-1,Win,2,2,2,0,0,2,0,1.5789473684210527,0.8947368421052632,1.4878048780487805,1.2682926829268293,1.0,3.0,4.0,1.0,0.0,1
2021, Jeenyo  FC , Geeska Afrika FC ,4,2,2,-2,Win,2,0,0,0,0,0,1,1.4366197183098592,1.5211267605633803,1.2173913043478262,2.5217391304347827,1.0,3.0,4.0,0.0,0.0,2
2021, Horseed S.C , Raadsan FC ,0,0,0,0,Draw,4,2,1,1,1,1,0,1.5714285714285714,0.935064935064935,1.59375,1.46875,0.0,3.0,1.0,0.5,0.5,0
2021, Mogadishu City Club , Elman FC ,2,2,0,0,Draw,4,2,3,0,0,3,8,1.7671232876712328,0.9041095890410958,1.75,1.144736842105263,0.0,3.0,3.0,0.2727272727272727,0.0,0
2021, Gaadiidka FC , Dekedda SC ,0,3,-3,3,Loss,1,0,0,3,3,0,7,1.2272727272727273,1.3333333333333333,1.662162162162162,0.8648648648648649,,1.0,2.0,0.0,0.3,-3
2021, Heegan S.C , Jeenyo  FC ,1,1,0,0,Draw,2,3,3,1,1,3,6,1.5789473684210527,0.8947368421052632,1.5846153846153845,1.4,0.0,3.0,1.0,0.3,0.1,0
2021, Horseed S.C , Midnimo FC ,5,2,3,-3,Win,3,1,2,0,0,2,0,1.5714285714285714,0.935064935064935,1.4878048780487805,1.2682926829268293,1.0,4.0,4.0,1.0,0.0,3
2021, Mogadishu City Club , Geeska Afrika FC ,4,0,4,-4,Win,3,0,0,0,0,0,0,1.7671232876712328,0.9041095890410958,1.2173913043478262,2.5217391304347827,1.0,3.0,4.0,,,4
2021, Gaadiidka FC , Raadsan FC ,1,1,0,0,Draw,1,2,1,2,2,1,0,1.2272727272727273,1.3333333333333333,1.59375,1.46875,0.0,1.0,1.0,0.3333333333333333,0.6666666666666666,0
2021, Dekedda SC , Elman FC ,1,1,0,0,Draw,1,2,4,5,5,4,2,1.7333333333333334,1.04,1.75,1.144736842105263,0.0,0.0,2.0,0.36363636363636365,0.45454545454545453,0
2021, Horseed S.C , Heegan S.C ,1,1,0,0,Draw,3,2,3,4,4,3,7,1.5714285714285714,0.935064935064935,1.917808219178082,0.8767123287671232,0.0,3.0,1.0,0.21428571428571427,0.2857142857142857,0
2021, Mogadishu City Club , Jeenyo  FC ,2,1,1,-1,Win,3,2,2,3,3,2,4,1.7671232876712328,0.9041095890410958,1.5846153846153845,1.4,1.0,3.0,2.0,0.2222222222222222,0.3333333333333333,1
2021, Gaadiidka FC , Midnimo FC ,1,2,-1,1,Loss,1,1,1,0,0,1,1,1.2272727272727273,1.3333333333333333,1.4878048780487805,1.2682926829268293,,0.0,3.0,0.5,0.0,-1
2021, Dekedda SC , Geeska Afrika FC ,1,2,-1,1,Loss,1,0,0,0,0,0,0,1.7333333333333334,1.04,1.2173913043478262,2.5217391304347827,,0.0,3.0,,,-1
2021, Elman FC , Raadsan FC ,3,2,1,-1,Win,1,2,1,1,1,1,0,1.8493150684931507,1.3287671232876712,1.59375,1.46875,1.0,3.0,2.0,0.5,0.5,1
2021, Heegan S.C , Mogadishu City Club ,1,0,1,-1,Win,1,3,1,3,3,1,8,1.5789473684210527,0.8947368421052632,1.96,0.7333333333333333,1.0,3.0,2.0,0.08333333333333333,0.25,1
2021, Gaadiidka FC , Horseed S.C ,0,5,-5,5,Loss,0,2,0,3,3,0,4,1.2272727272727273,1.3333333333333333,1.4583333333333333,1.1805555555555556,,0.0,0.0,0.0,0.42857142857142855,-5
2021, Dekedda SC , Jeenyo  FC ,3,1,2,-2,Win,1,2,4,2,2,4,4,1.7333333333333334,1.04,1.5846153846153845,1.4,1.0,1.0,2.0,0.4,0.2,2
2021, Elman FC , Midnimo FC ,0,2,-2,2,Loss,2,2,0,1,1,0,2,1.8493150684931507,1.3287671232876712,1.4878048780487805,1.2682926829268293,,3.0,3.0,0.0,0.3333333333333333,-2
2021, Raadsan FC , Geeska Afrika FC ,3,0,3,-3,Win,1,1,1,1,1,1,1,1.7407407407407407,1.4074074074074074,1.2173913043478262,2.5217391304347827,1.0,4.0,3.0,0.3333333333333333,0.3333333333333333,3
2021, Gaadiidka FC , Heegan S.C ,2,3,-1,1,Loss,0,2,0,6,6,0,2,1.2272727272727273,1.3333333333333333,1.917808219178082,0.8767123287671232,,0.0,1.0,0.0,0.75,-1
2021, Dekedda SC , Mogadishu City Club ,1,1,0,0,Draw,2,3,3,2,2,3,5,1.7333333333333334,1.04,1.96,0.7333333333333333,0.0,1.0,2.0,0.3,0.2,0
2021, Horseed S.C , Elman FC ,2,0,2,-2,Win,3,1,3,3,3,3,5,1.5714285714285714,0.935064935064935,1.75,1.144736842105263,1.0,3.0,2.0,0.2727272727272727,0.2727272727272727,2
2021, Raadsan FC , Jeenyo  FC ,0,0,0,0,Draw,2,2,0,0,0,0,1,1.7407407407407407,1.4074074074074074,1.5846153846153845,1.4,0.0,3.0,2.0,0.0,0.0,0
2021, Geeska Afrika FC , Midnimo FC ,0,4,-4,4,Loss,1,2,2,3,3,2,0,1.0434782608695652,2.9130434782608696,1.4878048780487805,1.2682926829268293,,0.0,2.0,0.4,0.6,-4
2021, Heegan S.C , Dekedda SC ,1,5,-4,4,Loss,3,2,3,3,3,3,6,1.5789473684210527,0.8947368421052632,1.662162162162162,0.8648648648648649,,2.0,1.0,0.25,0.25,-4
2021, Elman FC , Gaadiidka FC ,0,2,-2,2,Loss,1,0,5,1,1,5,2,1.8493150684931507,1.3287671232876712,1.588235294117647,1.5441176470588236,,2.0,2.0,0.625,0.125,-2
2021, Raadsan FC , Mogadishu City Club ,1,1,0,0,Draw,1,2,0,1,1,0,0,1.7407407407407407,1.4074074074074074,1.96,0.7333333333333333,0.0,2.0,2.0,0.0,1.0,0
2021, Geeska Afrika FC , Horseed S.C ,0,4,-4,4,Loss,1,3,0,1,1,0,0,1.0434782608695652,2.9130434782608696,1.4583333333333333,1.1805555555555556,,,0.0,0.0,1.0,-4
2021, Midnimo FC , Jeenyo  FC ,1,0,1,-1,Win,3,1,0,1,1,0,1,1.4857142857142858,1.3714285714285714,1.5846153846153845,1.4,1.0,3.0,3.0,0.0,0.5,1
2021, Elman FC , Heegan S.C ,1,2,-1,1,Loss,1,2,2,3,3,2,6,1.8493150684931507,1.3287671232876712,1.917808219178082,0.8767123287671232,,1.0,0.0,0.18181818181818182,0.2727272727272727,-1
2021, Raadsan FC , Dekedda SC ,0,2,-2,2,Loss,1,2,0,1,1,0,0,1.7407407407407407,1.4074074074074074,1.662162162162162,0.8648648648648649,,2.0,1.0,0.0,1.0,-2
2021, Geeska Afrika FC , Gaadiidka FC ,1,8,-7,7,Loss,1,1,0,1,1,0,0,1.0434782608695652,2.9130434782608696,1.588235294117647,1.5441176470588236,,,1.0,0.0,1.0,-7
2021, Midnimo FC , Mogadishu City Club ,0,2,-2,2,Loss,4,2,0,2,2,0,1,1.4857142857142858,1.3714285714285714,1.96,0.7333333333333333,,3.0,1.0,0.0,0.6666666666666666,-2
2021, Jeenyo  FC , Horseed S.C ,1,3,-2,2,Loss,0,4,3,3,3,3,3,1.4366197183098592,1.5211267605633803,1.4583333333333333,1.1805555555555556,,2.0,0.0,0.3333333333333333,0.3333333333333333,-2
2021, Heegan S.C , Raadsan FC ,0,1,-1,1,Loss,3,1,1,0,0,1,1,1.5789473684210527,0.8947368421052632,1.59375,1.46875,,2.0,1.0,0.5,0.0,-1
2021, Geeska Afrika FC , Elman FC ,0,5,-5,5,Loss,1,1,0,1,1,0,0,1.0434782608695652,2.9130434782608696,1.75,1.144736842105263,,,2.0,0.0,1.0,-5
2021, Midnimo FC , Dekedda SC ,0,0,0,0,Draw,4,3,0,1,1,0,2,1.4857142857142858,1.3714285714285714,1.662162162162162,0.8648648648648649,0.0,3.0,1.0,0.0,0.3333333333333333,0
2021, Jeenyo  FC , Gaadiidka FC ,1,2,-1,1,Loss,0,2,2,3,3,2,4,1.4366197183098592,1.5211267605633803,1.588235294117647,1.5441176470588236,,2.0,1.0,0.2222222222222222,0.3333333333333333,-1
2021, Horseed S.C , Mogadishu City Club ,0,0,0,0,Draw,4,2,2,5,5,2,6,1.5714285714285714,0.935064935064935,1.96,0.7333333333333333,0.0,2.0,1.0,0.15384615384615385,0.38461538461538464,0
2021, Geeska Afrika FC , Heegan S.C ,0,13,-13,13,Loss,0,3,0,0,0,0,1,1.0434782608695652,2.9130434782608696,1.917808219178082,0.8767123287671232,,,0.0,0.0,0.0,-13
2021, Midnimo FC , Raadsan FC ,0,2,-2,2,Loss,3,2,1,1,1,1,1,1.4857142857142858,1.3714285714285714,1.59375,1.46875,,2.0,1.0,0.3333333333333333,0.3333333333333333,-2
2021, Jeenyo  FC , Elman FC ,2,1,1,-1,Win,0,1,0,2,2,0,7,1.4366197183098592,1.5211267605633803,1.75,1.144736842105263,1.0,3.0,2.0,0.0,0.2222222222222222,1
2021, Horseed S.C , Dekedda SC ,1,0,1,-1,Win,4,3,2,2,2,2,7,1.5714285714285714,0.935064935064935,1.662162162162162,0.8648648648648649,1.0,3.0,1.0,0.18181818181818182,0.18181818181818182,1
2021, Mogadishu City Club , Gaadiidka FC ,4,2,2,-2,Win,1,3,6,1,1,6,2,1.7671232876712328,0.9041095890410958,1.588235294117647,1.5441176470588236,1.0,3.0,2.0,0.6666666666666666,0.1111111111111111,2
